State,City,Population,Total_law_employees,Total_officers,Total_civilians
Alabama,Abbeville,2545,10,9,1
Alabama,Adamsville,4257,25,14,11
Alabama,Addison,714,3,3,0
Alabama,Alabaster,33750,79,63,16
Alabama,Albertville,21769,67,45,22
Alabama,Alexander City,14251,68,53,15
Alabama,Aliceville,2230,6,5,1
Alabama,Altoona,910,5,5,0
Alabama,Andalusia,8643,35,28,7
Alabama,Anniston,21112,89,82,7
Alabama,Arab,8416,35,26,9
Alabama,Ardmore,1495,9,5,4
Alabama,Argo,4377,7,7,0
Alabama,Arley,344,2,2,0
Alabama,Ashford,2184,4,4,0
Alabama,Ashland,1880,9,8,1
Alabama,Ashville,2380,4,4,0
Alabama,Athens,28039,57,46,11
Alabama,Atmore,8997,34,25,9
Alabama,Attalla,5742,28,22,6
Alabama,Auburn,67814,139,130,9
Alabama,Baker Hill,249,4,3,1
Alabama,Bay Minette,9482,30,22,8
Alabama,Bayou La Batre,2466,18,13,5
Alabama,Bear Creek,1068,2,2,0
Alabama,Berry,1090,4,4,0
Alabama,Bessemer,26347,157,112,45
Alabama,Birmingham,209081,1034,828,206
Alabama,Blountsville,1668,5,5,0
Alabama,Boaz,9730,33,22,11
Alabama,Brantley,764,5,4,1
Alabama,Brent,4725,7,7,0
Alabama,Brewton,5189,33,24,9
Alabama,Bridgeport,2282,10,6,4
Alabama,Brighton,2757,14,8,6
Alabama,Brilliant,870,1,1,0
Alabama,Brookside,1325,16,12,4
Alabama,Brookwood,1851,6,6,0
Alabama,Brundidge,1884,10,6,4
Alabama,Calera,15093,43,34,9
Alabama,Camden,1739,11,9,2
Alabama,Camp Hill,944,5,5,0
Alabama,Carrollton,935,3,3,0
Alabama,Cedar Bluff,1823,6,6,0
Alabama,Centre,3547,14,13,1
Alabama,Centreville,2591,6,6,0
Alabama,Chatom,1171,3,3,0
Alabama,Cherokee,1004,1,1,0
Alabama,Chickasaw,5661,20,20,0
Alabama,Childersburg,4804,20,18,2
Alabama,Citronelle,3856,20,11,9
Alabama,Clanton,8812,26,25,1
Alabama,Clayton,2831,4,4,0
Alabama,Clio,1263,4,4,0
Alabama,Coaling,1663,4,4,0
Alabama,Coffeeville,319,3,3,0
Alabama,Collinsville,2012,8,4,4
Alabama,Columbia,737,2,2,0
Alabama,Columbiana,4596,15,11,4
Alabama,Coosada,1307,7,6,1
Alabama,Cordova,1825,6,4,2
Alabama,Cottonwood,1252,3,3,0
Alabama,Courtland,585,2,2,0
Alabama,Creola,2049,9,4,5
Alabama,Crossville,1856,5,5,0
Alabama,Cullman,16134,58,51,7
Alabama,Dadeville,3035,16,15,1
Alabama,Daleville,5080,22,16,6
Alabama,Daphne,27496,89,59,30
Alabama,Dauphin Island,1347,16,8,8
Alabama,Decatur,54295,152,133,19
Alabama,Demopolis,6525,26,22,4
Alabama,Dora,1890,12,8,4
Alabama,Dothan,69265,235,164,71
Alabama,Double Springs,1056,7,7,0
Alabama,Douglas,782,5,5,0
Alabama,East Brewton,2343,21,10,11
Alabama,Eclectic,1016,9,8,1
Alabama,Elba,3796,17,12,5
Alabama,Elberta,1775,11,10,1
Alabama,Enterprise,28569,74,58,16
Alabama,Eufaula,11568,55,34,21
Alabama,Eutaw,2570,8,7,1
Alabama,Evergreen,3482,25,19,6
Alabama,Excel,623,2,2,0
Alabama,Fairfield,10512,5,4,1
Alabama,Fairhope,23517,64,41,23
Alabama,Falkville,1254,8,6,2
Alabama,Fayette,4239,12,12,0
Alabama,Flomaton,1388,12,7,5
Alabama,Florala,1898,8,8,0
Alabama,Florence,40936,137,110,27
Alabama,Foley,21036,93,65,28
Alabama,Fort Deposit,1136,3,3,0
Alabama,Fort Payne,14071,35,35,0
Alabama,Frisco City,1137,2,2,0
Alabama,Fultondale,9391,35,28,7
Alabama,Fyffe,1048,5,5,0
Alabama,Gadsden,34791,126,97,29
Alabama,Gantt,215,6,4,2
Alabama,Gardendale,14198,41,31,10
Alabama,Geneva,4273,13,12,1
Alabama,Georgiana,1594,8,5,3
Alabama,Geraldine,897,6,6,0
Alabama,Gilbertown,191,3,2,1
Alabama,Glencoe,5063,10,9,1
Alabama,Goodwater,1298,8,4,4
Alabama,Gordo,1600,4,4,0
Alabama,Gordon,325,1,1,0
Alabama,Grant,918,2,2,0
Alabama,Greensboro,2245,9,9,0
Alabama,Greenville,7318,29,26,3
Alabama,Grove Hill,1717,7,6,1
Alabama,Guin,2264,7,7,0
Alabama,Gulf Shores,12985,71,50,21
Alabama,Guntersville,8606,46,35,11
Alabama,Gurley,809,6,6,0
Alabama,Hackleburg,1234,4,4,0
Alabama,Haleyville,4115,16,11,5
Alabama,Hamilton,6575,16,14,2
Alabama,Hanceville,3494,11,9,2
Alabama,Harpersville,1734,9,8,1
Alabama,Hartford,2574,15,11,4
Alabama,Hartselle,14486,29,28,1
Alabama,Hayneville,769,5,4,1
Alabama,Headland,4733,31,16,15
Alabama,Heflin,3400,12,11,1
Alabama,Helena,20279,35,30,5
Alabama,Henagar,2364,13,9,4
Alabama,Highland Lake,410,6,6,0
Alabama,Hillsboro,518,2,2,0
Alabama,Hokes Bluff,4254,9,9,0
Alabama,Hollywood,982,5,5,0
Alabama,Homewood,25407,118,81,37
Alabama,Hoover,86321,219,182,37
Alabama,Hueytown,15235,44,35,9
Alabama,Huntsville,202884,662,450,212
Alabama,Ider,717,7,3,4
Alabama,Irondale,12949,39,32,7
Alabama,Jackson,4583,24,20,4
Alabama,Jacksons Gap,827,2,2,0
Alabama,Jacksonville,12475,34,27,7
Alabama,Jasper,13327,70,46,24
Alabama,Jemison,2678,13,12,1
Alabama,Killen,951,4,4,0
Alabama,Kimberly,3660,6,6,0
Alabama,Kinsey,2274,1,1,0
Alabama,Kinston,548,2,1,1
Alabama,LaFayette,2901,14,13,1
Alabama,Lake View,2756,3,3,0
Alabama,Lanett,6117,31,29,2
Alabama,Leeds,12068,31,30,1
Alabama,Leesburg,1014,3,3,0
Alabama,Leighton,754,4,3,1
Alabama,Level Plains,1994,5,5,0
Alabama,Lexington,706,4,4,0
Alabama,Lincoln,6843,20,18,2
Alabama,Linden,1856,7,7,0
Alabama,Lineville,2231,11,7,4
Alabama,Lipscomb,2132,9,4,5
Alabama,Littleville,990,7,5,2
Alabama,Livingston,3240,10,7,3
Alabama,Louisville,456,2,2,0
Alabama,Loxley,3235,25,16,9
Alabama,Luverne,2737,13,11,2
Alabama,Lynn,633,1,1,0
Alabama,Madison,52573,109,78,31
Alabama,Maplesville,699,7,7,0
Alabama,Margaret,5222,7,7,0
Alabama,Marion,3067,5,5,0
Alabama,McIntosh,213,8,8,0
Alabama,McKenzie,488,3,3,0
Alabama,Mentone,369,2,2,0
Alabama,Midfield,4967,18,14,4
Alabama,Midland City,2377,4,4,0
Alabama,Millbrook,15993,56,40,16
Alabama,Millport,973,1,1,0
Alabama,Millry,492,1,1,0
Alabama,Mobile,243900,747,495,252
Alabama,Monroeville,5638,29,23,6
Alabama,Montevallo,6784,20,16,4
Alabama,Montgomery,197755,569,485,84
Alabama,Moody,13220,28,27,1
Alabama,Morris,2176,5,5,0
Alabama,Moulton,3217,11,11,0
Alabama,Moundville,2463,11,10,1
Alabama,Mountain Brook,20281,69,56,13
Alabama,Mount Vernon,1487,5,4,1
Alabama,Munford,1344,1,1,0
Alabama,Muscle Shoals,14737,28,26,2
Alabama,Napier Field,343,3,2,1
Alabama,New Brockton,1275,6,5,1
Alabama,New Hope,2927,6,6,0
Alabama,New Site,759,2,2,0
Alabama,Newton,1450,10,8,2
Alabama,Newville,509,1,1,0
Alabama,North Courtland,619,1,1,0
Alabama,Northport,26372,75,57,18
Alabama,Notasulga,808,8,3,5
Alabama,Oakman,718,1,1,0
Alabama,Odenville,3915,10,10,0
Alabama,Ohatchee,1153,6,6,0
Alabama,Oneonta,6576,27,26,1
Alabama,Opelika,31437,111,89,22
Alabama,Opp,6361,29,21,8
Alabama,Orange Beach,6329,75,49,26
Alabama,Owens Crossroads,2206,4,4,0
Alabama,Oxford,21191,71,69,2
Alabama,Ozark,14215,39,32,7
Alabama,Parrish,932,2,2,0
Alabama,Pelham,24188,82,66,16
Alabama,Pell City,14195,42,40,2
Alabama,Phenix City,36883,104,80,24
Alabama,Pickensville,575,1,1,0
Alabama,Piedmont,4501,22,16,6
Alabama,Pine Hill,840,5,5,0
Alabama,Pleasant Grove,9551,20,15,5
Alabama,Powell,968,4,4,0
Alabama,Prattville,36162,87,80,7
Alabama,Priceville,3940,7,7,0
Alabama,Prichard,21305,56,35,21
Alabama,Ragland,1731,4,4,0
Alabama,Rainbow City,9610,37,23,14
Alabama,Rainsville,5138,14,10,4
Alabama,Ranburne,397,3,2,1
Alabama,Red Bay,3077,13,9,4
Alabama,Red Level,477,2,2,0
Alabama,Reform,1537,6,6,0
Alabama,River Falls,536,3,3,0
Alabama,Riverside,2395,5,5,0
Alabama,Roanoke,5894,28,23,5
Alabama,Robertsdale,6961,28,16,12
Alabama,Rogersville,1250,6,6,0
Alabama,Russellville,9723,31,27,4
Alabama,Samson,1844,7,7,0
Alabama,Saraland,14751,58,46,12
Alabama,Sardis City,1783,5,5,0
Alabama,Satsuma,6195,18,14,4
Alabama,Scottsboro,14398,69,42,27
Alabama,Selma,16876,58,42,16
Alabama,Sheffield,8886,31,29,2
Alabama,Shorter,388,6,5,1
Alabama,Silverhill,1238,7,6,1
Alabama,Skyline,837,1,1,0
Alabama,Slocomb,1890,11,11,0
Alabama,Snead,838,13,13,0
Alabama,Somerville,774,4,4,0
Alabama,Southside,8957,19,13,6
Alabama,Spanish Fort,9511,28,24,4
Alabama,Springville,4325,11,11,0
Alabama,Steele,1094,3,3,0
Alabama,Stevenson,1941,7,5,2
Alabama,St. Florian,708,4,4,0
Alabama,Sulligent,1825,6,6,0
Alabama,Summerdale,1804,12,11,1
Alabama,Sylacauga,11955,40,39,1
Alabama,Sylvania,1897,3,3,0
Alabama,Talladega,15398,47,43,4
Alabama,Tallassee,4482,27,20,7
Alabama,Tarrant,6080,26,20,6
Alabama,Taylor,2437,5,4,1
Alabama,Thomasville,3799,21,21,0
Alabama,Thorsby,2063,6,6,0
Alabama,Town Creek,1032,2,2,0
Alabama,Trafford,615,1,1,0
Alabama,Triana,1026,3,3,0
Alabama,Trinity,2490,7,7,0
Alabama,Troy,19041,80,62,18
Alabama,Trussville,22961,78,65,13
Alabama,Tuscaloosa,102391,354,283,71
Alabama,Tuscumbia,8446,28,21,7
Alabama,Tuskegee,7973,29,18,11
Alabama,Union Springs,3365,21,12,9
Alabama,Uniontown,2181,6,5,1
Alabama,Valley,9101,29,27,2
Alabama,Valley Head,548,2,2,0
Alabama,Vance,1672,5,5,0
Alabama,Vernon,1835,9,9,0
Alabama,Vestavia Hills,34489,102,99,3
Alabama,Wadley,710,5,5,0
Alabama,Warrior,3214,17,10,7
Alabama,Weaver,3060,11,8,3
Alabama,Wedowee,791,10,9,1
Alabama,West Blocton,1248,1,1,0
Alabama,Wetumpka,8562,33,30,3
Alabama,Winfield,4497,14,13,1
Alabama,Woodstock,1663,5,5,0
Alabama,York,2208,4,4,0
Alaska,Anchorage,286388,592,425,167
Alaska,Bethel,6642,24,11,13
Alaska,Bristol Bay Borough,817,9,4,5
Alaska,Cordova,2161,10,4,6
Alaska,Craig,1268,10,5,5
Alaska,Dillingham,2364,20,8,12
Alaska,Fairbanks,30832,38,33,5
Alaska,Haines,2524,10,5,5
Alaska,Homer,6028,22,12,10
Alaska,Hoonah,794,9,5,4
Alaska,Juneau,31925,83,48,35
Alaska,Kenai,7885,27,17,10
Alaska,Ketchikan,8307,38,25,13
Alaska,Klawock,790,2,2,0
Alaska,Kodiak,5778,39,16,23
Alaska,Kotzebue,3249,18,10,8
Alaska,Nome,3900,17,10,7
Alaska,North Pole,2090,13,11,2
Alaska,North Slope Borough,9836,76,45,31
Alaska,Palmer,7641,24,14,10
Alaska,Petersburg,3259,14,8,6
Alaska,Sand Point,1073,6,5,1
Alaska,Seward,2806,22,9,13
Alaska,Sitka,8420,26,14,12
Alaska,Skagway,1206,9,3,6
Alaska,Soldotna,4782,17,14,3
Alaska,Unalaska,4439,23,12,11
Alaska,Valdez,3841,12,12,0
Alaska,Wasilla,11228,30,26,4
Alaska,Whittier,203,5,5,0
Alaska,Wrangell,2508,11,5,6
Arizona,Apache Junction,43385,101,65,36
Arizona,Avondale,89338,198,133,65
Arizona,Benson,4854,22,15,7
Arizona,Bisbee,5184,20,14,6
Arizona,Buckeye,83608,130,96,34
Arizona,Bullhead City,41035,101,67,34
Arizona,Camp Verde,11223,35,22,13
Arizona,Casa Grande,59822,99,80,19
Arizona,Chandler,264071,472,318,154
Arizona,Chino Valley,12564,31,26,5
Arizona,Clarkdale,4433,9,8,1
Arizona,Clifton,3761,10,4,6
Arizona,Colorado City,4838,13,9,4
Arizona,Coolidge,13277,40,27,13
Arizona,Cottonwood,12380,52,29,23
Arizona,Douglas,16044,42,28,14
Arizona,Eagar,4944,8,6,2
Arizona,El Mirage,36221,69,51,18
Arizona,Eloy,19981,36,26,10
Arizona,Flagstaff,76107,149,104,45
Arizona,Florence,27571,34,25,9
Arizona,Fredonia,1275,3,3,0
Arizona,Gilbert,259629,422,289,133
Arizona,Glendale,255468,548,400,148
Arizona,Globe,7328,27,23,4
Arizona,Goodyear,89607,154,115,39
Arizona,Hayden,976,5,5,0
Arizona,Holbrook,5088,13,11,2
Arizona,Huachuca City,1723,7,5,2
Arizona,Jerome,456,5,5,0
Arizona,Kearny,2193,12,8,4
Arizona,Kingman,31351,64,47,17
Arizona,Lake Havasu City,56243,109,71,38
Arizona,Mammoth,1709,4,4,0
Arizona,Marana,50942,124,96,28
Arizona,Maricopa,53165,84,67,17
Arizona,Mesa,527361,1268,828,440
Arizona,Miami,1774,12,7,5
Arizona,Nogales,20026,63,46,17
Arizona,Oro Valley,46634,122,96,26
Arizona,Page,7546,30,19,11
Arizona,Paradise Valley,14859,45,34,11
Arizona,Parker,3224,12,10,2
Arizona,Patagonia,870,3,3,0
Arizona,Payson,15869,44,25,19
Arizona,Peoria,178486,297,197,100
Arizona,Phoenix,1708960,3903,2939,964
Arizona,Pima,2580,5,5,0
Arizona,Pinetop-Lakeside,4490,18,14,4
Arizona,Prescott,44835,90,75,15
Arizona,Prescott Valley,47459,95,72,23
Arizona,Quartzsite,3772,12,11,1
Arizona,Safford,10033,24,21,3
Arizona,Sahuarita,32053,59,49,10
Arizona,San Luis,35574,59,37,22
Arizona,Scottsdale,263006,613,379,234
Arizona,Sedona,10373,43,24,19
Arizona,Show Low,11527,51,30,21
Arizona,Sierra Vista,42800,84,66,18
Arizona,Snowflake-Taylor,10384,16,14,2
Arizona,Somerton,16811,27,19,8
Arizona,South Tucson,5723,17,16,1
Arizona,Springerville,1979,8,6,2
Arizona,St. Johns,3514,10,7,3
Arizona,Superior,3212,10,9,1
Arizona,Surprise,144620,199,140,59
Arizona,Tempe,199935,487,346,141
Arizona,Thatcher,5242,12,11,1
Arizona,Tolleson,7470,46,30,16
Arizona,Tombstone,1294,9,7,2
Arizona,Tucson,550448,1087,855,232
Arizona,Wellton,3062,7,6,1
Arizona,Wickenburg,7041,25,20,5
Arizona,Willcox,3509,18,11,7
Arizona,Williams,3271,21,11,10
Arizona,Winslow,9298,43,23,20
Arizona,Yuma,99096,227,137,90
Arkansas,Alexander,3524,10,10,0
Arkansas,Alma,5904,19,15,4
Arkansas,Altus,726,1,1,0
Arkansas,Amity,681,3,1,2
Arkansas,Arkadelphia,10732,29,23,6
Arkansas,Ashdown,4367,14,12,2
Arkansas,Ash Flat,1099,6,6,0
Arkansas,Atkins,3040,9,8,1
Arkansas,Augusta,1917,5,5,0
Arkansas,Austin,4401,4,4,0
Arkansas,Bald Knob,2864,14,8,6
Arkansas,Barling,5076,10,10,0
Arkansas,Batesville,10938,26,25,1
Arkansas,Bay,1823,4,4,0
Arkansas,Beebe,8268,23,17,6
Arkansas,Bella Vista,29138,52,36,16
Arkansas,Benton,37542,77,68,9
Arkansas,Bentonville,57575,115,83,32
Arkansas,Berryville,5577,16,14,2
Arkansas,Blytheville,13239,53,36,17
Arkansas,Booneville,3765,13,9,4
Arkansas,Bradford,734,2,2,0
Arkansas,Brinkley,2531,15,9,6
Arkansas,Bryant,21497,57,46,11
Arkansas,Bull Shoals,1945,7,4,3
Arkansas,Cabot,26593,54,43,11
Arkansas,Caddo Valley,637,5,4,1
Arkansas,Camden,10605,36,18,18
Arkansas,Cammack Village,713,4,4,0
Arkansas,Caraway,1283,3,3,0
Arkansas,Carlisle,2149,9,5,4
Arkansas,Cave Springs,5888,9,9,0
Arkansas,Centerton,17220,24,22,2
Arkansas,Charleston,2462,5,5,0
Arkansas,Cherokee Village,4657,8,7,1
Arkansas,Cherry Valley,576,1,1,0
Arkansas,Clarendon,1330,3,3,0
Arkansas,Clarksville,9829,23,19,4
Arkansas,Clinton,2505,8,7,1
Arkansas,Conway,68599,162,118,44
Arkansas,Corning,3018,10,6,4
Arkansas,Cotter,949,3,3,0
Arkansas,Crossett,4723,26,17,9
Arkansas,Damascus,382,1,1,0
Arkansas,Danville,2391,6,5,1
Arkansas,Dardanelle,4520,17,11,6
Arkansas,Decatur,1801,5,5,0
Arkansas,De Queen,6526,17,14,3
Arkansas,Des Arc,1568,6,6,0
Arkansas,DeWitt,2976,13,8,5
Arkansas,Diamond City,802,1,1,0
Arkansas,Diaz,1196,3,3,0
Arkansas,Dover,1446,5,5,0
Arkansas,Dumas,3984,16,12,4
Arkansas,Dyer,901,1,1,0
Arkansas,Earle,2156,3,3,0
Arkansas,El Dorado,17523,67,51,16
Arkansas,Elkins,3588,10,10,0
Arkansas,England,2673,12,8,4
Arkansas,Etowah,313,1,1,0
Arkansas,Eudora,1866,6,4,2
Arkansas,Eureka Springs,2110,18,13,5
Arkansas,Fairfield Bay,2173,17,7,10
Arkansas,Farmington,7575,18,18,0
Arkansas,Fayetteville,89252,171,125,46
Arkansas,Flippin,1319,7,7,0
Arkansas,Fordyce,3646,11,7,4
Arkansas,Forrest City,13656,38,29,9
Arkansas,Fort Smith,88071,193,148,45
Arkansas,Gassville,2168,4,4,0
Arkansas,Gentry,4086,12,10,2
Arkansas,Gillett,680,2,1,1
Arkansas,Glenwood,2117,4,4,0
Arkansas,Gosnell,3066,6,6,0
Arkansas,Gravette,3558,12,11,1
Arkansas,Greenbrier,5779,14,9,5
Arkansas,Green Forest,2760,14,12,2
Arkansas,Greenland,1416,4,4,0
Arkansas,Greenwood,9449,20,18,2
Arkansas,Greers Ferry,853,5,4,1
Arkansas,Gurdon,2069,5,4,1
Arkansas,Guy,792,2,2,0
Arkansas,Hamburg,2574,7,6,1
Arkansas,Hampton,1251,4,4,0
Arkansas,Hardy,765,5,5,0
Arkansas,Harrisburg,2309,7,5,2
Arkansas,Harrison,13096,45,34,11
Arkansas,Haskell,4667,8,8,0
Arkansas,Hazen,1331,7,6,1
Arkansas,Heber Springs,6880,17,16,1
Arkansas,Helena-West Helena,10086,28,15,13
Arkansas,Higginson,737,1,1,0
Arkansas,Highfill,641,4,4,0
Arkansas,Highland,1113,3,3,0
Arkansas,Hope,9543,35,25,10
Arkansas,Hot Springs,38893,137,100,37
Arkansas,Hughes,1193,4,3,1
Arkansas,Huntsville,2585,10,8,2
Arkansas,Jacksonville,28217,67,56,11
Arkansas,Johnson,3781,9,8,1
Arkansas,Jonesboro,79702,178,163,15
Arkansas,Judsonia,1991,4,3,1
Arkansas,Kensett,1613,3,3,0
Arkansas,Lake City,2720,4,4,0
Arkansas,Lakeview,718,2,2,0
Arkansas,Lake Village,2155,13,7,6
Arkansas,Lamar,1734,3,3,0
Arkansas,Lavaca,2441,3,3,0
Arkansas,Leachville,1835,5,4,1
Arkansas,Lead Hill,265,1,1,0
Arkansas,Lewisville,1097,2,2,0
Arkansas,Lincoln,2503,6,6,0
Arkansas,Little Flock,2816,7,7,0
Arkansas,Little Rock,197688,736,560,176
Arkansas,Lonoke,4178,16,12,4
Arkansas,Lowell,9825,27,21,6
Arkansas,Luxora,1011,1,1,0
Arkansas,Magnolia,11434,24,22,2
Arkansas,Malvern,10966,23,21,2
Arkansas,Mammoth Spring,959,2,2,0
Arkansas,Mansfield,1090,4,4,0
Arkansas,Marianna,3325,23,13,10
Arkansas,Marion,12285,34,29,5
Arkansas,Marked Tree,2405,14,8,6
Arkansas,Marmaduke,1265,4,4,0
Arkansas,Marshall,1330,4,4,0
Arkansas,Marvell,892,7,4,3
Arkansas,Maumelle,18307,49,37,12
Arkansas,Mayflower,2418,9,8,1
Arkansas,McCrory,1464,6,5,1
Arkansas,McGehee,3631,25,13,12
Arkansas,McRae,667,1,1,0
Arkansas,Mena,5461,14,13,1
Arkansas,Menifee,319,2,1,1
Arkansas,Mineral Springs,1142,4,3,1
Arkansas,Monette,1602,3,3,0
Arkansas,Monticello,9348,29,21,8
Arkansas,Morrilton,6631,27,24,3
Arkansas,Mountainburg,612,1,1,0
Arkansas,Mountain Home,12582,38,31,7
Arkansas,Mountain View,2875,11,10,1
Arkansas,Mulberry,1697,4,4,0
Arkansas,Murfreesboro,1576,3,3,0
Arkansas,Nashville,4360,17,16,1
Arkansas,Newport,7423,24,18,6
Arkansas,North Little Rock,66303,218,185,33
Arkansas,Ola,1203,4,3,1
Arkansas,Osceola,6527,34,24,10
Arkansas,Ozark,3583,13,11,2
Arkansas,Paragould,29288,57,51,6
Arkansas,Paris,3345,13,8,5
Arkansas,Patterson,385,1,1,0
Arkansas,Pea Ridge,6398,16,15,1
Arkansas,Perryville,1457,5,5,0
Arkansas,Piggott,3494,7,7,0
Arkansas,Pine Bluff,40718,134,111,23
Arkansas,Plumerville,768,2,2,0
Arkansas,Pocahontas,6647,18,17,1
Arkansas,Pottsville,3390,9,7,2
Arkansas,Prairie Grove,7058,16,16,0
Arkansas,Prescott,2957,12,6,6
Arkansas,Quitman,714,4,4,0
Arkansas,Ravenden,448,1,1,0
Arkansas,Redfield,1540,7,6,1
Arkansas,Rogers,70194,154,116,38
Arkansas,Rose Bud,488,4,3,1
Arkansas,Russellville,29266,61,55,6
Arkansas,Salem,1679,4,4,0
Arkansas,Searcy,23742,72,53,19
Arkansas,Shannon Hills,4098,5,5,0
Arkansas,Sheridan,4963,30,16,14
Arkansas,Sherwood,31636,100,76,24
Arkansas,Siloam Springs,17332,54,39,15
Arkansas,Springdale,85146,205,146,59
Arkansas,Stamps,1442,1,1,0
Arkansas,Star City,2005,6,5,1
Arkansas,St. Charles,210,1,1,0
Arkansas,Stuttgart,8402,30,22,8
Arkansas,Sulphur Springs,530,3,3,0
Arkansas,Swifton,726,2,2,0
Arkansas,Texarkana,29622,86,75,11
Arkansas,Trumann,6934,26,19,7
Arkansas,Tuckerman,1663,4,4,0
Arkansas,Turrell,549,1,1,0
Arkansas,Tyronza,717,2,2,0
Arkansas,Van Buren,23779,64,50,14
Arkansas,Vilonia,4719,8,8,0
Arkansas,Waldron,3344,10,9,1
Arkansas,Walnut Ridge,5023,8,8,0
Arkansas,Ward,5517,12,11,1
Arkansas,Warren,5546,23,14,9
Arkansas,Weiner,669,1,1,0
Arkansas,West Fork,2688,7,6,1
Arkansas,West Memphis,24205,95,75,20
Arkansas,White Hall,4904,19,17,2
Arkansas,Wilson,805,1,1,0
Arkansas,Wynne,7682,22,20,2
California,Alameda,78047,105,72,33
California,Albany,19830,31,22,9
California,Alhambra,83817,124,81,43
California,Alturas,2535,8,8,0
California,Anaheim,351913,556,402,154
California,Anderson,10705,27,19,8
California,Angels Camp,3974,7,6,1
California,Antioch,112481,166,120,46
California,Arcadia,58122,89,63,26
California,Arcata,18516,38,25,13
California,Arroyo Grande,18054,25,22,3
California,Arvin,22149,24,16,8
California,Atascadero,30266,38,28,10
California,Atherton,7162,28,20,8
California,Atwater,29704,33,23,10
California,Auburn,14293,27,20,7
California,Avenal,13321,19,17,2
California,Azusa,50373,80,53,27
California,Bakersfield,388265,588,403,185
California,Baldwin Park,75233,84,63,21
California,Banning,31392,42,26,16
California,Barstow,24041,58,41,17
California,Bear Valley,121,6,5,1
California,Beaumont,52884,56,41,15
California,Bell,35526,41,30,11
California,Bell Gardens,42008,67,45,22
California,Belmont,27063,44,32,12
California,Belvedere,2107,6,6,0
California,Benicia,28374,49,31,18
California,Berkeley,122346,254,163,91
California,Beverly Hills,33776,226,134,92
California,Bishop,3733,19,11,8
California,Blythe,19590,30,20,10
California,Brawley,26363,40,26,14
California,Brea,43705,100,57,43
California,Brentwood,66061,95,64,31
California,Brisbane,4716,17,14,3
California,Broadmoor,4176,8,7,1
California,Buena Park,81901,130,87,43
California,Burbank,102419,230,147,83
California,Burlingame,31126,59,39,20
California,Calexico,39957,39,24,15
California,California City,14286,25,14,11
California,Calistoga,5255,16,11,5
California,Campbell,41921,73,42,31
California,Capitola,10020,27,21,6
California,Carlsbad,116516,180,128,52
California,Carmel,3825,21,14,7
California,Cathedral City,55417,67,47,20
California,Central Marin,34593,44,40,4
California,Ceres,49028,63,47,16
California,Chico,105355,144,94,50
California,Chino,96309,165,114,51
California,Chowchilla,18278,30,20,10
California,Chula Vista,278027,342,243,99
California,Citrus Heights,88314,130,83,47
California,Claremont,36422,62,38,24
California,Clayton,12420,13,11,2
California,Clearlake,15268,39,21,18
California,Cloverdale,8660,21,13,8
California,Clovis,116809,165,98,67
California,Coalinga,17061,24,17,7
California,Colma,1495,24,18,6
California,Colton,55117,76,52,24
California,Colusa,6042,10,9,1
California,Concord,130074,178,135,43
California,Corcoran,21700,31,17,14
California,Corning,7714,21,13,8
California,Corona,171848,209,142,67
California,Coronado,23750,70,47,23
California,Costa Mesa,113317,190,129,61
California,Cotati,7426,17,12,5
California,Covina,47413,80,58,22
California,Crescent City,6706,13,12,1
California,Culver City,39218,144,110,34
California,Cypress,49124,60,45,15
California,Daly City,106855,127,98,29
California,Davis,69853,88,56,32
California,Delano,53625,68,50,18
California,Del Rey Oaks,1657,10,10,0
California,Desert Hot Springs,29074,33,26,7
California,Dinuba,24807,46,33,13
California,Dixon,20967,31,26,5
California,Dos Palos,5594,16,11,5
California,Downey,111054,160,116,44
California,East Palo Alto,29439,45,37,8
California,El Cajon,103035,176,120,56
California,El Centro,44238,63,43,20
California,El Cerrito,25725,46,38,8
California,Elk Grove,177331,242,135,107
California,El Monte,115690,157,118,39
California,El Segundo,16605,73,53,20
California,Emeryville,12328,54,37,17
California,Escalon,7625,13,12,1
California,Escondido,152446,208,151,57
California,Etna,716,4,4,0
California,Eureka,26656,71,46,25
California,Exeter,10501,18,17,1
California,Fairfax,7530,16,11,5
California,Fairfield,118491,179,117,62
California,Farmersville,10716,17,16,1
California,Ferndale,1350,8,8,0
California,Firebaugh,8377,17,12,5
California,Folsom,82427,102,75,27
California,Fontana,216553,297,186,111
California,Fort Bragg,7289,19,14,5
California,Fortuna,12283,24,18,6
California,Foster City,34291,52,37,15
California,Fountain Valley,55345,77,58,19
California,Fowler,6929,12,12,0
California,Fremont,244259,301,195,106
California,Fresno,535472,1026,788,238
California,Fullerton,139011,181,121,60
California,Galt,26867,44,31,13
California,Gardena,59385,104,82,22
California,Garden Grove,171698,236,171,65
California,Gilroy,60269,90,60,30
California,Glendale,200168,354,225,129
California,Glendora,51676,78,48,30
California,Gonzales,8321,13,10,3
California,Grass Valley,12811,32,26,6
California,Greenfield,17643,30,24,6
California,Gridley,7320,17,11,6
California,Grover Beach,13491,26,19,7
California,Guadalupe,7865,15,13,2
California,Gustine,5922,9,7,2
California,Hanford,58075,86,60,26
California,Hawthorne,86269,137,92,45
California,Hayward,160891,287,174,113
California,Healdsburg,11907,23,16,7
California,Hemet,86058,104,70,34
California,Hercules,26524,26,22,4
California,Hermosa Beach,19300,64,35,29
California,Hillsborough,11447,35,26,9
California,Hollister,41438,39,31,8
California,Huntington Beach,200128,321,199,122
California,Huntington Park,57442,82,54,28
California,Huron,7343,8,6,2
California,Imperial,18528,24,21,3
California,Indio,93219,112,70,42
California,Inglewood,107986,249,191,58
California,Ione,8674,9,9,0
California,Irvine,297069,319,218,101
California,Irwindale,1449,34,27,7
California,Jackson,4861,10,9,1
California,Kensington,5077,10,10,0
California,Kerman,15478,27,23,4
California,King City,14214,18,16,2
California,Kingsburg,12182,21,18,3
California,Laguna Beach,22834,98,54,44
California,La Habra,60672,98,68,30
California,Lakeport,5035,12,11,1
California,Lake Shastina,2561,3,3,0
California,La Mesa,59488,92,66,26
California,La Palma,15415,26,19,7
California,La Verne,32073,52,37,15
California,Lemoore,26980,40,32,8
California,Lincoln,48887,32,24,8
California,Lindsay,13668,18,17,1
California,Livermore,91200,125,88,37
California,Livingston,15115,25,16,9
California,Lodi,68207,100,71,29
California,Lompoc,42915,60,35,25
California,Long Beach,462654,1174,809,365
California,Los Alamitos,11400,23,19,4
California,Los Altos,30203,45,32,13
California,Los Angeles,4000587,12863,9863,3000
California,Los Banos,41631,71,43,28
California,Los Gatos,30271,59,39,20
California,Madera,66351,97,69,28
California,Mammoth Lakes,8236,19,15,4
California,Manhattan Beach,35190,99,60,39
California,Manteca,84929,101,73,28
California,Marina,23147,36,28,8
California,Martinez,38543,46,33,13
California,Marysville,12519,27,17,10
California,McFarland,15858,14,11,3
California,Mendota,11531,16,14,2
California,Menifee,96837,80,58,22
California,Menlo Park,35002,57,42,15
California,Merced,84197,132,94,38
California,Mill Valley,14297,26,20,6
California,Milpitas,86416,121,82,39
California,Modesto,216560,302,203,99
California,Monrovia,36302,71,44,27
California,Montclair,40473,61,36,25
California,Montebello,61895,93,70,23
California,Monterey,28209,65,48,17
California,Monterey Park,59609,106,75,31
California,Moraga,17986,13,11,2
California,Morgan Hill,46925,58,38,20
California,Morro Bay,10577,19,17,2
California,Mountain View,83745,132,88,44
California,Mount Shasta,3261,12,8,4
California,Murrieta,117639,151,100,51
California,Napa,78237,112,69,43
California,National City,61710,114,82,32
California,Nevada City,3156,10,8,2
California,Newark,49934,75,51,24
California,Newman,11965,14,12,2
California,Newport Beach,84448,217,137,80
California,Novato,55926,75,54,21
California,Oakdale,23926,31,22,9
California,Oakland,437923,1056,740,316
California,Oceanside,176616,299,208,91
California,Ontario,187464,337,258,79
California,Orange,138846,218,150,68
California,Orange Cove,10334,11,10,1
California,Orland,7878,14,11,3
California,Oroville,20983,37,21,16
California,Oxnard,210064,325,227,98
California,Pacifica,38677,34,31,3
California,Pacific Grove,15451,32,21,11
California,Palm Springs,48952,147,97,50
California,Palo Alto,65459,123,80,43
California,Palos Verdes Estates,13255,26,17,9
California,Paradise,4072,24,16,8
California,Parlier,15734,22,18,4
California,Pasadena,141473,358,233,125
California,Paso Robles,32428,50,35,15
California,Petaluma,60806,96,57,39
California,Piedmont,11184,30,20,10
California,Pinole,19350,43,26,17
California,Pismo Beach,8226,31,19,12
California,Pittsburg,73673,103,85,18
California,Placentia,51260,68,48,20
California,Placerville,11255,26,18,8
California,Pleasant Hill,35032,56,43,13
California,Pleasanton,83164,109,78,31
California,Pomona,151982,244,152,92
California,Porterville,59757,100,68,32
California,Port Hueneme,21949,30,20,10
California,Red Bluff,14590,36,23,13
California,Redding,92895,142,101,41
California,Redlands,71820,117,84,33
California,Redondo Beach,66729,143,85,58
California,Redwood City,86983,116,84,32
California,Reedley,25800,45,30,15
California,Rialto,104004,141,106,35
California,Richmond,111367,200,145,55
California,Ridgecrest,29120,49,31,18
California,Rio Dell,3347,5,5,0
California,Rio Vista,10020,14,12,2
California,Ripon,16616,32,22,10
California,Riverside,334370,522,379,143
California,Rocklin,70219,84,60,24
California,Rohnert Park,43572,97,71,26
California,Roseville,144128,196,136,60
California,Ross,2454,8,8,0
California,Sacramento,519050,1012,684,328
California,Salinas,155984,200,150,50
California,San Bernardino,216365,334,239,95
California,San Bruno,42997,57,42,15
California,Sand City,407,11,10,1
California,San Diego,1437608,2424,1846,578
California,San Fernando,24399,40,27,13
California,San Francisco,881514,2992,2239,753
California,San Gabriel,39927,64,51,13
California,Sanger,25457,40,35,5
California,San Jose,1029542,1631,1170,461
California,San Leandro,89239,130,89,41
California,San Luis Obispo,47722,84,59,25
California,San Marino,13042,34,26,8
California,San Mateo,105246,151,108,43
California,San Pablo,31164,83,56,27
California,San Rafael,58512,89,64,25
California,San Ramon,76502,83,67,16
California,Santa Ana,333107,594,366,228
California,Santa Barbara,91692,199,131,68
California,Santa Clara,131976,216,145,71
California,Santa Cruz,65073,115,83,32
California,Santa Maria,108140,181,133,48
California,Santa Monica,90474,373,212,161
California,Santa Paula,29861,42,31,11
California,Santa Rosa,176932,252,174,78
California,Sausalito,7080,25,19,6
California,Scotts Valley,11777,24,17,7
California,Seal Beach,23873,52,37,15
California,Seaside,33822,44,32,12
California,Sebastopol,7697,21,15,6
California,Selma,24982,44,32,12
California,Shafter,20799,41,28,13
California,Sierra Madre,10779,21,16,5
California,Signal Hill,11467,44,32,12
California,Simi Valley,125742,165,124,41
California,Soledad,26000,21,17,4
California,Sonora,4860,17,10,7
California,South Gate,93336,123,77,46
California,South Lake Tahoe,22286,53,37,16
California,South Pasadena,25299,50,34,16
California,South San Francisco,68260,109,79,30
California,Stallion Springs,2488,4,4,0
California,St. Helena,6134,17,11,6
California,Stockton,314981,663,468,195
California,Suisun City,29842,33,21,12
California,Sunnyvale,154133,289,217,72
California,Susanville,14740,19,16,3
California,Sutter Creek,2634,5,5,0
California,Taft,9274,22,12,10
California,Tehachapi,12873,27,17,10
California,Tiburon,9098,17,13,4
California,Torrance,143421,298,194,104
California,Tracy,96067,142,92,50
California,Truckee,16800,40,25,15
California,Tulare,66207,113,67,46
California,Tulelake,975,2,2,0
California,Turlock,74183,111,76,35
California,Tustin,79795,141,90,51
California,Ukiah,15992,43,27,16
California,Union City,74625,86,69,17
California,Upland,77511,102,71,31
California,Vacaville,101616,171,116,55
California,Vallejo,122326,163,111,52
California,Ventura,109295,186,131,55
California,Vernon,110,55,44,11
California,Visalia,135733,216,150,66
California,Walnut Creek,70849,117,80,37
California,Watsonville,54151,87,69,18
California,Weed,2699,14,8,6
California,West Covina,104989,133,90,43
California,Westminster,90741,123,89,34
California,Westmorland,2256,3,3,0
California,West Sacramento,54068,95,71,24
California,Wheatland,3916,8,8,0
California,Whittier,85074,169,120,49
California,Williams,5443,12,10,2
California,Willits,4887,12,8,4
California,Winters,7397,11,9,2
California,Woodlake,7697,12,11,1
California,Woodland,61123,81,66,15
California,Yreka,7489,21,13,8
California,Yuba City,67165,88,64,24
Colorado,Alamosa,9669,29,25,4
Colorado,Arvada,122983,242,185,57
Colorado,Aspen,7478,36,25,11
Colorado,Ault,1913,6,5,1
Colorado,Aurora,385720,906,770,136
Colorado,Avon,6526,21,19,2
Colorado,Basalt,4195,11,10,1
Colorado,Bayfield,2731,9,8,1
Colorado,Black Hawk,129,34,23,11
Colorado,Blue River,929,4,4,0
Colorado,Boulder,106598,264,176,88
Colorado,Breckenridge,4991,25,21,4
Colorado,Brighton,42536,110,79,31
Colorado,Broomfield,71795,222,115,107
Colorado,Brush,5413,15,10,5
Colorado,Buena Vista,2902,8,7,1
Colorado,Burlington,3043,7,3,4
Colorado,Calhan,840,4,4,0
Colorado,Canon City,16761,45,37,8
Colorado,Carbondale,6955,15,12,3
Colorado,Castle Rock,71150,113,82,31
Colorado,Cedaredge,2301,5,4,1
Colorado,Centennial,112104,173,143,30
Colorado,Center,2266,18,6,12
Colorado,Cherry Hills Village,6722,28,23,5
Colorado,Collbran,699,3,3,0
Colorado,Colorado Springs,485083,1018,725,293
Colorado,Columbine Valley,1528,6,6,0
Colorado,Commerce City,62164,135,105,30
Colorado,Cortez,8764,51,28,23
Colorado,Craig,8975,25,20,5
Colorado,Crested Butte,1751,9,8,1
Colorado,Cripple Creek,1261,20,11,9
Colorado,Dacono,6285,17,13,4
Colorado,De Beque,520,5,5,0
Colorado,Del Norte,1556,4,3,1
Colorado,Delta,9011,24,18,6
Colorado,Denver,737709,1818,1552,266
Colorado,Dillon,974,9,8,1
Colorado,Dinosaur,331,3,3,0
Colorado,Durango,19220,63,50,13
Colorado,Eagle,7043,13,12,1
Colorado,Eaton,5911,12,10,2
Colorado,Edgewater,5353,18,18,0
Colorado,Elizabeth,1591,10,9,1
Colorado,Empire,307,3,2,1
Colorado,Englewood,35464,106,76,30
Colorado,Erie,28198,44,37,7
Colorado,Estes Park,6480,36,22,14
Colorado,Evans,21515,38,35,3
Colorado,Fairplay,797,3,3,0
Colorado,Federal Heights,12983,40,25,15
Colorado,Firestone,17013,37,30,7
Colorado,Florence,3952,13,11,2
Colorado,Fort Collins,173274,323,222,101
Colorado,Fort Lupton,8421,24,19,5
Colorado,Fort Morgan,11471,32,25,7
Colorado,Fountain,31297,59,51,8
Colorado,Fowler,1136,5,4,1
Colorado,Fraser/Winter Park,2438,11,10,1
Colorado,Frederick,14712,29,24,5
Colorado,Frisco,3231,12,9,3
Colorado,Fruita,13574,19,16,3
Colorado,Garden City,269,4,4,0
Colorado,Georgetown,1121,3,3,0
Colorado,Glendale,5243,40,27,13
Colorado,Glenwood Springs,9976,26,19,7
Colorado,Golden,20981,61,45,16
Colorado,Granby,2174,10,8,2
Colorado,Grand Junction,64149,214,111,103
Colorado,Greeley,110505,212,155,57
Colorado,Green Mountain Falls,730,1,1,0
Colorado,Greenwood Village,15945,84,63,21
Colorado,Gunnison,6736,20,15,5
Colorado,Gypsum,7479,4,4,0
Colorado,Haxtun,899,2,2,0
Colorado,Hayden,1999,6,4,2
Colorado,Holyoke,2195,4,4,0
Colorado,Hotchkiss,929,4,4,0
Colorado,Hudson,2817,8,6,2
Colorado,Hugo,782,2,2,0
Colorado,Idaho Springs,1793,12,9,3
Colorado,Ignacio,914,8,8,0
Colorado,Johnstown,15932,27,24,3
Colorado,Kersey,1704,5,4,1
Colorado,Lafayette,31457,47,36,11
Colorado,La Junta,6859,19,10,9
Colorado,Lakeside,8,5,4,1
Colorado,Lakewood,159719,408,295,113
Colorado,Lamar,7625,20,14,6
Colorado,La Salle,2389,6,6,0
Colorado,La Veta,813,1,1,0
Colorado,Leadville,2900,9,6,3
Colorado,Limon,1960,6,5,1
Colorado,Littleton,48805,99,74,25
Colorado,Lochbuie,7653,13,10,3
Colorado,Log Lane Village,852,2,2,0
Colorado,Lone Tree,13423,58,49,9
Colorado,Longmont,98545,227,156,71
Colorado,Louisville,21101,37,31,6
Colorado,Loveland,80302,159,108,51
Colorado,Mancos,1440,4,4,0
Colorado,Manitou Springs,5435,18,15,3
Colorado,Manzanola,415,3,2,1
Colorado,Mead,4897,11,9,2
Colorado,Meeker,2231,6,5,1
Colorado,Milliken,8509,15,11,4
Colorado,Monte Vista,4104,15,13,2
Colorado,Montrose,19864,61,41,20
Colorado,Monument,8361,22,19,3
Colorado,Morrison,425,9,8,1
Colorado,Mountain View,540,10,9,1
Colorado,Mountain Village,1439,10,7,3
Colorado,Mount Crested Butte,883,9,8,1
Colorado,Nederland,1543,4,4,0
Colorado,New Castle,5289,10,9,1
Colorado,Northglenn,39161,78,62,16
Colorado,Oak Creek,966,3,3,0
Colorado,Olathe,1834,5,5,0
Colorado,Ouray,1037,5,5,0
Colorado,Pagosa Springs,2127,7,6,1
Colorado,Palisade,2745,10,9,1
Colorado,Palmer Lake,3048,2,2,0
Colorado,Paonia,1470,6,5,1
Colorado,Parachute,1121,5,4,1
Colorado,Parker,59245,105,67,38
Colorado,Platteville,3905,9,8,1
Colorado,Pueblo,113002,265,208,57
Colorado,Rangely,2254,12,6,6
Colorado,Ridgway,1057,3,3,0
Colorado,Rifle,9747,24,19,5
Colorado,Rocky Ford,3798,10,5,5
Colorado,Salida,6183,21,18,3
Colorado,Severance,7040,9,8,1
Colorado,Sheridan,6246,35,34,1
Colorado,Silt,3222,7,5,2
Colorado,Silverthorne,5021,19,16,3
Colorado,Simla,643,1,1,0
Colorado,Snowmass Village,2723,12,9,3
Colorado,South Fork,422,3,3,0
Colorado,Springfield,1366,4,3,1
Colorado,Steamboat Springs,13345,39,26,13
Colorado,Sterling,14459,27,21,6
Colorado,Telluride,2508,14,10,4
Colorado,Thornton,144156,311,236,75
Colorado,Timnath,6289,11,9,2
Colorado,Trinidad,8114,36,23,13
Colorado,Vail,5450,61,28,33
Colorado,Westminster,113941,267,193,74
Colorado,Wheat Ridge,31451,106,86,20
Colorado,Wiggins,1201,2,2,0
Colorado,Windsor,32169,50,43,7
Colorado,Woodland Park,7969,34,25,9
Colorado,Wray,2345,7,6,1
Colorado,Yuma,3475,9,8,1
Connecticut,Ansonia,18586,52,42,10
Connecticut,Avon,18289,41,31,10
Connecticut,Berlin,20497,53,41,12
Connecticut,Bethel,19932,52,39,13
Connecticut,Bloomfield,21294,56,43,13
Connecticut,Branford,27886,60,48,12
Connecticut,Bridgeport,144350,409,364,45
Connecticut,Bristol,59886,142,117,25
Connecticut,Brookfield,17031,44,34,10
Connecticut,Canton,10249,20,15,5
Connecticut,Cheshire,28897,60,47,13
Connecticut,Clinton,12890,36,27,9
Connecticut,Coventry,12404,21,16,5
Connecticut,Cromwell,13822,37,27,10
Connecticut,Danbury,85080,154,149,5
Connecticut,Darien,21840,63,51,12
Connecticut,Derby,12281,35,33,2
Connecticut,East Hampton,12783,20,18,2
Connecticut,East Hartford,49720,155,118,37
Connecticut,East Haven,28498,58,54,4
Connecticut,East Lyme,18391,34,26,8
Connecticut,Easton,7522,20,15,5
Connecticut,East Windsor,11723,35,25,10
Connecticut,Enfield,43551,117,95,22
Connecticut,Fairfield,62311,107,100,7
Connecticut,Farmington,25512,58,44,14
Connecticut,Glastonbury,34487,76,59,17
Connecticut,Granby,11531,21,16,5
Connecticut,Greenwich,63012,177,150,27
Connecticut,Groton,8861,33,26,7
Connecticut,Groton Long Point,506,5,5,0
Connecticut,Groton Town,28890,82,65,17
Connecticut,Guilford,22106,42,35,7
Connecticut,Hamden,60440,122,96,26
Connecticut,Hartford,121749,458,430,28
Connecticut,Ledyard,14575,31,22,9
Connecticut,Madison,18004,41,30,11
Connecticut,Manchester,57510,145,113,32
Connecticut,Meriden,59238,127,116,11
Connecticut,Middlebury,7819,14,12,2
Connecticut,Middletown,46106,136,112,24
Connecticut,Milford,54968,130,108,22
Connecticut,Monroe,19427,53,44,9
Connecticut,Naugatuck,31024,69,58,11
Connecticut,New Britain,72412,163,155,8
Connecticut,New Canaan,20281,53,47,6
Connecticut,New Haven,130299,375,325,50
Connecticut,Newington,29957,63,50,13
Connecticut,New London,26776,84,68,16
Connecticut,New Milford,26668,59,46,13
Connecticut,Newtown,27924,47,44,3
Connecticut,North Branford,14115,28,22,6
Connecticut,North Haven,23639,61,49,12
Connecticut,Norwalk,89140,202,175,27
Connecticut,Norwich,38576,101,87,14
Connecticut,Old Saybrook,10042,30,22,8
Connecticut,Orange,13922,53,43,10
Connecticut,Plainfield,15095,26,17,9
Connecticut,Plainville,17519,49,40,9
Connecticut,Plymouth,11529,22,20,2
Connecticut,Portland,9242,13,12,1
Connecticut,Putnam,9370,20,15,5
Connecticut,Redding,9112,23,16,7
Connecticut,Ridgefield,24990,46,41,5
Connecticut,Rocky Hill,20160,47,35,12
Connecticut,Seymour,16426,43,40,3
Connecticut,Shelton,41302,50,44,6
Connecticut,Simsbury,25614,46,36,10
Connecticut,Southington,43906,88,69,19
Connecticut,South Windsor,26213,58,44,14
Connecticut,Stamford,130425,288,263,25
Connecticut,Stonington,18563,48,37,11
Connecticut,Stratford,51895,108,103,5
Connecticut,Suffield,15820,25,19,6
Connecticut,Thomaston,7497,27,16,11
Connecticut,Torrington,33796,82,73,9
Connecticut,Trumbull,35632,88,77,11
Connecticut,Vernon,29379,64,50,14
Connecticut,Wallingford,44236,95,74,21
Connecticut,Waterbury,107263,333,287,46
Connecticut,Waterford,18664,54,49,5
Connecticut,Watertown,21475,49,40,9
Connecticut,West Hartford,62911,146,124,22
Connecticut,West Haven,54516,135,127,8
Connecticut,Weston,10258,18,17,1
Connecticut,Westport,28728,77,63,14
Connecticut,Wethersfield,25936,61,47,14
Connecticut,Willimantic,17737,49,44,5
Connecticut,Wilton,18375,46,43,3
Connecticut,Winchester,10536,25,22,3
Connecticut,Windsor,28692,58,45,13
Connecticut,Windsor Locks,12894,35,27,8
Connecticut,Wolcott,16573,33,25,8
Connecticut,Woodbridge,8725,31,23,8
Delaware,Bethany Beach,1268,11,10,1
Delaware,Blades,1479,3,3,0
Delaware,Bridgeville,2409,7,7,0
Delaware,Camden,3562,10,9,1
Delaware,Cheswold,1718,4,4,0
Delaware,Clayton,3577,10,9,1
Delaware,Dagsboro,943,3,3,0
Delaware,Delaware City,1844,4,3,1
Delaware,Delmar,1850,13,12,1
Delaware,Dewey Beach,407,11,9,2
Delaware,Dover,38428,123,92,31
Delaware,Ellendale,442,1,1,0
Delaware,Elsmere,5851,12,11,1
Delaware,Felton,1429,3,3,0
Delaware,Fenwick Island,453,7,7,0
Delaware,Frederica,859,2,2,0
Delaware,Georgetown,7698,23,21,2
Delaware,Greenwood,1159,4,3,1
Delaware,Harrington,3646,11,10,1
Delaware,Laurel,4431,19,18,1
Delaware,Lewes,3378,12,11,1
Delaware,Middletown,23385,45,38,7
Delaware,Milford,11994,48,35,13
Delaware,Millsboro,4613,18,16,2
Delaware,Milton,3066,9,8,1
Delaware,Newark,33752,90,73,17
Delaware,New Castle,5420,18,17,1
Delaware,Newport,1035,6,6,0
Delaware,Ocean View,2231,12,11,1
Delaware,Rehoboth Beach,1573,29,18,11
Delaware,Seaford,8145,35,28,7
Delaware,Selbyville,2585,9,8,1
Delaware,Smyrna,12011,33,25,8
Delaware,South Bethany,540,6,6,0
Delaware,Wilmington,70100,349,293,56
Delaware,Wyoming,1577,3,3,0
District of Columbia,Washington,712816,4466,3766,700
Florida,Alachua,9998,37,28,9
Florida,Altamonte Springs,44440,112,95,17
Florida,Apopka,54842,139,104,35
Florida,Arcadia,8392,22,18,4
Florida,Atlantic Beach,14012,39,26,13
Florida,Atlantis,2144,16,11,5
Florida,Auburndale,17046,45,37,8
Florida,Aventura,37114,124,88,36
Florida,Bal Harbour Village,2992,36,24,12
Florida,Bartow,20507,55,35,20
Florida,Bay Harbor Islands,5821,25,21,4
Florida,Belleair,4297,17,15,2
Florida,Belle Isle,7392,20,18,2
Florida,Belleview,5168,17,15,2
Florida,Biscayne Park,3063,10,10,0
Florida,Blountstown,2435,20,14,6
Florida,Boca Raton,101583,314,214,100
Florida,Bonifay,2698,6,5,1
Florida,Bowling Green,2882,6,6,0
Florida,Boynton Beach,79913,194,134,60
Florida,Bradenton,60688,152,119,33
Florida,Bradenton Beach,1292,10,10,0
Florida,Cape Coral,199503,337,255,82
Florida,Casselberry,29080,63,53,10
Florida,Cedar Key,719,3,3,0
Florida,Chiefland,2181,14,12,2
Florida,Clearwater,117859,336,237,99
Florida,Clermont,39932,87,80,7
Florida,Clewiston,8125,22,16,6
Florida,Cocoa,18769,93,62,31
Florida,Cocoa Beach,11763,58,39,19
Florida,Coconut Creek,62220,140,105,35
Florida,Coral Gables,50017,268,178,90
Florida,Coral Springs,135027,307,216,91
Florida,Crestview,25787,43,38,5
Florida,Cross City,1711,5,5,0
Florida,Dade City,7444,31,23,8
Florida,Davenport,6516,15,14,1
Florida,Davie,107988,262,186,76
Florida,Daytona Beach,70084,287,231,56
Florida,Daytona Beach Shores,4656,38,29,9
Florida,DeFuniak Springs,7200,27,20,7
Florida,DeLand,35874,75,58,17
Florida,Delray Beach,70487,235,162,73
Florida,Doral,68425,196,145,51
Florida,Dunnellon,1852,10,9,1
Florida,Eatonville,2223,14,12,2
Florida,Edgewater,24166,37,31,6
Florida,El Portal,2397,9,9,0
Florida,Eustis,21642,51,37,14
Florida,Fernandina Beach,13383,40,35,5
Florida,Flagler Beach,5195,18,15,3
Florida,Florida City,11826,44,34,10
Florida,Fort Lauderdale,184347,674,517,157
Florida,Fort Myers,90380,310,233,77
Florida,Fort Pierce,46574,143,114,29
Florida,Fort Walton Beach,22871,61,50,11
Florida,Fruitland Park,12021,21,20,1
Florida,Gainesville,135076,367,268,99
Florida,Golden Beach,934,27,19,8
Florida,Graceville,2109,9,9,0
Florida,Green Cove Springs,8783,28,21,7
Florida,Groveland,17622,52,37,15
Florida,Gulf Breeze,7037,29,20,9
Florida,Gulfport,12378,34,30,4
Florida,Gulf Stream,995,13,13,0
Florida,Haines City,26719,68,54,14
Florida,Havana,1703,14,10,4
Florida,Hialeah,234235,350,277,73
Florida,Hialeah Gardens,23667,61,43,18
Florida,Hillsboro Beach,2027,19,15,4
Florida,Holly Hill,12440,25,21,4
Florida,Hollywood,156434,407,319,88
Florida,Holmes Beach,4360,23,17,6
Florida,Homestead,70538,146,113,33
Florida,Howey-in-the-Hills,1191,6,6,0
Florida,Indialantic,2929,18,12,6
Florida,Indian Creek Village,89,13,9,4
Florida,Indian Harbour Beach,8602,28,20,8
Florida,Indian River Shores,4363,26,22,4
Florida,Indian Shores,3787,13,12,1
Florida,Interlachen,1471,3,3,0
Florida,Jacksonville,920508,3078,1789,1289
Florida,Jacksonville Beach,23894,86,67,19
Florida,Jasper,4127,6,6,0
Florida,Jay,646,8,7,1
Florida,Juno Beach,3710,15,13,2
Florida,Jupiter,67054,140,111,29
Florida,Jupiter Inlet Colony,459,4,4,0
Florida,Jupiter Island,942,23,18,5
Florida,Kenneth City,5131,15,14,1
Florida,Key Biscayne,12898,47,36,11
Florida,Key Colony Beach,804,4,4,0
Florida,Kissimmee,74337,226,148,78
Florida,Lady Lake,16255,33,28,5
Florida,Lake Alfred,6425,18,13,5
Florida,Lake City,12403,53,38,15
Florida,Lake Clarke Shores,3653,11,10,1
Florida,Lake Hamilton,1530,9,7,2
Florida,Lake Helen,2822,7,6,1
Florida,Lakeland,113876,351,239,112
Florida,Lake Mary,17947,54,46,8
Florida,Lake Placid,2498,10,8,2
Florida,Lake Wales,17075,52,45,7
Florida,Lantana,12825,37,30,7
Florida,Largo,85594,164,133,31
Florida,Lauderhill,72421,145,114,31
Florida,Lawtey,725,3,3,0
Florida,Leesburg,24063,88,64,24
Florida,Lighthouse Point,11373,40,32,8
Florida,Live Oak,6985,22,19,3
Florida,Longboat Key,7342,21,18,3
Florida,Longwood,15793,48,43,5
Florida,Lynn Haven,20733,50,37,13
Florida,Madison,2735,16,15,1
Florida,Maitland,17863,61,53,8
Florida,Manalapan,473,16,14,2
Florida,Marco Island,18121,36,32,4
Florida,Margate,59449,147,113,34
Florida,Marianna,5644,21,16,5
Florida,Mascotte,6468,14,12,2
Florida,Medley,888,54,40,14
Florida,Melbourne,83806,221,145,76
Florida,Melbourne Beach,3321,11,10,1
Florida,Melbourne Village,698,4,4,0
Florida,Miami,476102,1737,1317,420
Florida,Miami Beach,89017,500,416,84
Florida,Miami Gardens,110284,261,212,49
Florida,Miami Shores,10358,46,39,7
Florida,Miami Springs,13925,57,46,11
Florida,Midway,2995,5,4,1
Florida,Milton,10728,27,20,7
Florida,Miramar,143470,283,203,80
Florida,Monticello,2397,14,8,6
Florida,Mount Dora,14801,63,47,16
Florida,Naples,22388,101,68,33
Florida,Neptune Beach,7285,30,22,8
Florida,New Port Richey,16954,58,42,16
Florida,New Smyrna Beach,28380,60,45,15
Florida,Niceville,16345,37,29,8
Florida,North Bay Village,8165,35,26,9
Florida,North Miami,63109,149,118,31
Florida,North Miami Beach,43273,137,104,33
Florida,North Palm Beach,13255,37,32,5
Florida,North Port,72389,158,121,37
Florida,Oakland,3193,13,12,1
Florida,Ocala,61275,290,187,103
Florida,Ocean Ridge,1976,23,18,5
Florida,Ocoee,49877,110,87,23
Florida,Okeechobee,5833,30,22,8
Florida,Opa Locka,15962,52,44,8
Florida,Orange City,12454,30,26,4
Florida,Orange Park,8864,35,26,9
Florida,Orlando,293363,1074,806,268
Florida,Ormond Beach,44271,85,65,20
Florida,Oviedo,42903,77,71,6
Florida,Palatka,10436,35,32,3
Florida,Palm Bay,116897,212,151,61
Florida,Palm Beach,8891,94,65,29
Florida,Palm Beach Gardens,58629,178,122,56
Florida,Palmetto,13873,48,34,14
Florida,Palm Springs,25451,61,43,18
Florida,Panama City,34672,120,85,35
Florida,Panama City Beach,12703,87,67,20
Florida,Parker,4241,11,10,1
Florida,Pembroke Pines,175757,331,235,96
Florida,Pensacola,53083,180,134,46
Florida,Perry,6865,22,20,2
Florida,Pinellas Park,54114,125,108,17
Florida,Plantation,95669,253,164,89
Florida,Plant City,40330,83,66,17
Florida,Ponce Inlet,3340,14,12,2
Florida,Port Orange,65828,109,83,26
Florida,Port Richey,2963,22,15,7
Florida,Port St. Lucie,206450,310,242,68
Florida,Punta Gorda,20766,55,37,18
Florida,Quincy,6707,36,25,11
Florida,Riviera Beach,35798,151,110,41
Florida,Rockledge,28614,66,50,16
Florida,Sanford,62342,155,139,16
Florida,Sanibel,7511,36,23,13
Florida,Sarasota,59002,224,175,49
Florida,Satellite Beach,11252,34,24,10
Florida,Sea Ranch Lakes,626,11,7,4
Florida,Sebastian,26626,57,41,16
Florida,Sebring,10664,39,33,6
Florida,Sewall's Point,2252,10,9,1
Florida,Shalimar,850,5,4,1
Florida,Sneads,1771,7,6,1
Florida,South Daytona,13176,33,27,6
Florida,South Miami,11933,57,50,7
Florida,Springfield,8542,28,24,4
Florida,Starke,5415,18,16,2
Florida,St. Augustine Beach,7101,22,20,2
Florida,St. Cloud,56828,137,93,44
Florida,St. Petersburg,267690,776,557,219
Florida,Stuart,16347,61,45,16
Florida,Sunny Isles Beach,21907,65,52,13
Florida,Sunrise,96428,236,181,55
Florida,Surfside,5659,37,31,6
Florida,Sweetwater,21109,57,51,6
Florida,Tallahassee,196012,459,366,93
Florida,Tampa,407350,1181,926,255
Florida,Tavares,18221,32,29,3
Florida,Temple Terrace,26890,68,51,17
Florida,Tequesta,6193,20,19,1
Florida,Titusville,46919,129,86,43
Florida,Treasure Island,6946,23,19,4
Florida,Trenton,2179,3,2,1
Florida,Umatilla,3910,9,8,1
Florida,Valparaiso,5449,17,12,5
Florida,Venice,24366,68,50,18
Florida,Vero Beach,17776,76,57,19
Florida,Village of Pinecrest,19255,69,47,22
Florida,Virginia Gardens,2380,8,7,1
Florida,Wauchula,4773,18,15,3
Florida,Welaka,718,1,1,0
Florida,West Melbourne,25020,57,51,6
Florida,West Miami,9154,26,21,5
Florida,West Palm Beach,113268,390,292,98
Florida,White Springs,765,2,2,0
Florida,Wildwood,7568,40,36,4
Florida,Wilton Manors,12885,47,33,14
Florida,Winter Garden,47484,104,77,27
Florida,Winter Haven,46275,113,81,32
Florida,Winter Park,31183,103,74,29
Florida,Winter Springs,37788,64,50,14
Florida,Zephyrhills,16772,51,36,15
Georgia,Abbeville,2654,7,6,1
Georgia,Acworth,23085,67,48,19
Georgia,Adairsville,4998,18,16,2
Georgia,Alamo,3340,4,4,0
Georgia,Alapaha,676,2,1,1
Georgia,Albany,71567,196,162,34
Georgia,Alma,3370,17,15,2
Georgia,Alpharetta,68326,120,108,12
Georgia,Alto,1200,5,2,3
Georgia,Americus,14910,41,32,9
Georgia,Aragon,1344,9,4,5
Georgia,Arcade,1991,3,3,0
Georgia,Athens-Clarke County,128152,273,215,58
Georgia,Atlanta,515945,2015,1548,467
Georgia,Attapulgus,423,2,1,1
Georgia,Auburn,7730,20,16,4
Georgia,Austell,7245,33,23,10
Georgia,Avondale Estates,3149,15,15,0
Georgia,Bainbridge,12006,50,37,13
Georgia,Ball Ground,2290,5,5,0
Georgia,Barnesville,6653,18,18,0
Georgia,Bartow,246,1,1,0
Georgia,Baxley,4655,12,11,1
Georgia,Blackshear,3535,20,17,3
Georgia,Blairsville,646,8,7,1
Georgia,Blakely,4521,16,14,2
Georgia,Bloomingdale,2691,17,15,2
Georgia,Blue Ridge,1474,8,8,0
Georgia,Blythe,709,3,3,0
Georgia,Boston,1317,5,5,0
Georgia,Bowdon,2107,8,7,1
Georgia,Braselton,13758,19,18,1
Georgia,Braswell,384,2,1,1
Georgia,Bremen,6685,21,19,2
Georgia,Brookhaven,56248,86,72,14
Georgia,Brooklet,1870,5,4,1
Georgia,Brunswick,16365,61,56,5
Georgia,Buchanan,1184,9,8,1
Georgia,Buena Vista,2037,4,4,0
Georgia,Butler,1739,7,7,0
Georgia,Byron,5304,28,25,3
Georgia,Cairo,9340,26,23,3
Georgia,Calhoun,17387,52,44,8
Georgia,Camilla,4981,21,18,3
Georgia,Canon,790,1,1,0
Georgia,Canton,31416,61,53,8
Georgia,Carrollton,27609,85,70,15
Georgia,Cartersville,21995,57,47,10
Georgia,Cave Spring,1061,3,3,0
Georgia,Cecil,283,3,2,1
Georgia,Cedartown,10020,36,32,4
Georgia,Centerville,7960,20,17,3
Georgia,Chamblee,30716,77,63,14
Georgia,Chatsworth,4290,18,17,1
Georgia,Chickamauga,3258,7,7,0
Georgia,Clarkston,12697,15,15,0
Georgia,Claxton,2185,15,10,5
Georgia,Cleveland,4251,17,16,1
Georgia,Cochran,4984,12,11,1
Georgia,Cohutta,637,4,4,0
Georgia,College Park,15204,109,82,27
Georgia,Columbus,195998,487,386,101
Georgia,Conyers,16368,83,61,22
Georgia,Coolidge,529,3,3,0
Georgia,Cordele,10451,27,18,9
Georgia,Cornelia,4741,20,18,2
Georgia,Covington,14330,61,48,13
Georgia,Cumming,6669,22,20,2
Georgia,Dallas,14280,34,24,10
Georgia,Dalton,33723,99,86,13
Georgia,Darien,1920,10,10,0
Georgia,Dawson,4073,14,8,6
Georgia,Decatur,26473,59,47,12
Georgia,Demorest,2157,11,7,4
Georgia,Dillard,378,4,3,1
Georgia,Doerun,732,5,4,1
Georgia,Donalsonville,2445,10,9,1
Georgia,Doraville,10329,57,40,17
Georgia,Douglas,11696,39,34,5
Georgia,Douglasville,34409,110,95,15
Georgia,Dublin,15849,71,59,12
Georgia,Duluth,29946,74,57,17
Georgia,Dunwoody,49687,74,61,13
Georgia,East Ellijay,571,7,7,0
Georgia,Eastman,5018,16,14,2
Georgia,Eatonton,6753,23,16,7
Georgia,Edison,1380,5,4,1
Georgia,Elberton,4303,25,23,2
Georgia,Ellaville,1872,4,4,0
Georgia,Ellijay,1725,12,11,1
Georgia,Emerson,1610,9,8,1
Georgia,Enigma,1352,6,4,2
Georgia,Eton,903,4,4,0
Georgia,Euharlee,4393,12,11,1
Georgia,Fairburn,17220,54,43,11
Georgia,Fayetteville,18202,62,54,8
Georgia,Fitzgerald,8611,32,24,8
Georgia,Flowery Branch,8671,18,16,2
Georgia,Folkston,5072,7,7,0
Georgia,Forest Park,20202,85,64,21
Georgia,Forsyth,4160,20,18,2
Georgia,Fort Oglethorpe,10072,29,26,3
Georgia,Fort Valley,8877,35,23,12
Georgia,Franklin,968,8,8,0
Georgia,Franklin Springs,1222,2,2,0
Georgia,Gainesville,44398,117,101,16
Georgia,Garden City,8716,42,35,7
Georgia,Glennville,5004,11,9,2
Georgia,Gordon,1841,11,6,5
Georgia,Grantville,3322,14,13,1
Georgia,Gray,3273,14,13,1
Georgia,Greensboro,3299,20,16,4
Georgia,Greenville,842,8,6,2
Georgia,Griffin,22773,81,72,9
Georgia,Grovetown,15650,31,22,9
Georgia,Guyton,2297,5,5,0
Georgia,Hagan,962,4,3,1
Georgia,Hahira,3060,11,9,2
Georgia,Hampton,8201,20,18,2
Georgia,Hartwell,4445,27,22,5
Georgia,Hazlehurst,4126,13,11,2
Georgia,Helen,565,12,11,1
Georgia,Hephzibah,3933,7,7,0
Georgia,Hiawassee,916,5,5,0
Georgia,Hinesville,33316,95,82,13
Georgia,Hiram,4301,20,17,3
Georgia,Hogansville,3138,20,15,5
Georgia,Holly Springs,16345,39,38,1
Georgia,Homeland,943,7,7,0
Georgia,Homerville,2340,10,8,2
Georgia,Irwinton,552,2,2,0
Georgia,Jackson,5259,15,13,2
Georgia,Jacksonville,132,1,1,0
Georgia,Jasper,4009,19,17,2
Georgia,Jefferson,12349,26,24,2
Georgia,Jesup,9807,33,31,2
Georgia,Johns Creek,85408,86,77,9
Georgia,Jonesboro,4994,32,20,12
Georgia,Kennesaw,34481,69,59,10
Georgia,Kingston,684,2,1,1
Georgia,LaGrange,30406,105,86,19
Georgia,Lake City,2855,17,15,2
Georgia,Lakeland,3273,11,9,2
Georgia,Lavonia,2204,14,14,0
Georgia,Lawrenceville,31256,92,68,24
Georgia,Leesburg,3073,13,13,0
Georgia,Leslie,367,4,3,1
Georgia,Lilburn,12941,34,29,5
Georgia,Lithonia,2374,7,6,1
Georgia,Locust Grove,8575,29,26,3
Georgia,Loganville,13187,34,32,2
Georgia,Lookout Mountain,1571,7,7,0
Georgia,Louisville,2187,6,6,0
Georgia,Ludowici,2355,10,6,4
Georgia,Lyons,4218,20,16,4
Georgia,Madison,4236,12,11,1
Georgia,Manchester,3942,19,14,5
Georgia,Marietta,61348,178,132,46
Georgia,Marshallville,1206,2,2,0
Georgia,Maysville,2135,3,3,0
Georgia,McDonough,27338,54,48,6
Georgia,McIntyre,601,5,5,0
Georgia,McRae-Helena,8246,12,11,1
Georgia,Metter,3927,13,12,1
Georgia,Midville,252,1,1,0
Georgia,Midway,2059,6,4,2
Georgia,Milledgeville,18751,58,41,17
Georgia,Millen,2730,11,11,0
Georgia,Milton,40368,44,38,6
Georgia,Monroe,13761,50,47,3
Georgia,Montezuma,2903,12,10,2
Georgia,Morrow,7327,24,22,2
Georgia,Moultrie,14199,41,37,4
Georgia,Mount Airy,1268,5,1,4
Georgia,Mount Zion,1825,7,6,1
Georgia,Nahunta,1152,4,4,0
Georgia,Nashville,4839,17,12,5
Georgia,Newington,261,1,1,0
Georgia,Newnan,42658,101,86,15
Georgia,Norcross,16778,60,36,24
Georgia,Norman Park,961,2,2,0
Georgia,Oakwood,4180,21,20,1
Georgia,Ocilla,3759,13,13,0
Georgia,Oglethorpe,1138,6,5,1
Georgia,Omega,1231,6,5,1
Georgia,Oxford,2372,4,4,0
Georgia,Palmetto,4890,17,14,3
Georgia,Peachtree City,36421,69,64,5
Georgia,Pearson,2035,6,5,1
Georgia,Pelham,3420,13,11,2
Georgia,Pembroke,2685,10,9,1
Georgia,Pendergrass,576,2,2,0
Georgia,Perry,18417,49,41,8
Georgia,Pine Lake,757,4,4,0
Georgia,Pine Mountain,1430,11,10,1
Georgia,Pooler,26634,65,57,8
Georgia,Port Wentworth,10281,39,28,11
Georgia,Powder Springs,15971,31,29,2
Georgia,Remerton,1074,9,8,1
Georgia,Richmond Hill,14437,39,33,6
Georgia,Rincon,10525,19,17,2
Georgia,Ringgold,3646,9,8,1
Georgia,Rochelle,1096,7,5,2
Georgia,Rockmart,4458,22,20,2
Georgia,Rome,36747,91,81,10
Georgia,Roswell,95396,185,138,47
Georgia,Sandersville,5346,21,15,6
Georgia,Sandy Springs,111219,160,141,19
Georgia,Smyrna,57317,140,93,47
Georgia,Snellville,20282,57,45,12
Georgia,Social Circle,4583,16,15,1
Georgia,South Fulton,100658,156,138,18
Georgia,Sparks,2010,3,3,0
Georgia,Sparta,1213,12,7,5
Georgia,Springfield,4281,10,9,1
Georgia,Stapleton,388,2,2,0
Georgia,Statesboro,33498,91,77,14
Georgia,Stone Mountain,6332,19,18,1
Georgia,Summerville,4215,16,14,2
Georgia,Suwanee,21633,51,39,12
Georgia,Swainsboro,7577,25,23,2
Georgia,Sylvania,2449,11,8,3
Georgia,Sylvester,5732,30,25,5
Georgia,Tallapoosa,3186,12,10,2
Georgia,Temple,4832,16,13,3
Georgia,Thomaston,8711,29,25,4
Georgia,Thunderbolt,2634,9,7,2
Georgia,Toccoa,8312,32,31,1
Georgia,Tunnel Hill,911,3,3,0
Georgia,Twin City,1696,2,2,0
Georgia,Tybee Island,3072,38,25,13
Georgia,Tyrone,7575,16,16,0
Georgia,Union City,22744,65,59,6
Georgia,Valdosta,56628,162,138,24
Georgia,Vidalia,10398,39,28,11
Georgia,Villa Rica,16296,52,43,9
Georgia,Warner Robins,78508,156,113,43
Georgia,Warwick,383,5,3,2
Georgia,Waycross,13363,64,51,13
Georgia,Waynesboro,5308,30,23,7
Georgia,Winder,18376,42,34,8
Georgia,Woodstock,34252,64,55,9
Hawaii,Honolulu,966438,2516,2005,511
Idaho,Aberdeen,1975,5,5,0
Idaho,American Falls,4298,10,8,2
Idaho,Ashton,1042,2,2,0
Idaho,Bellevue,2471,2,2,0
Idaho,Blackfoot,12036,30,27,3
Idaho,Boise,231223,373,288,85
Idaho,Bonners Ferry,2652,7,7,0
Idaho,Buhl,4544,9,8,1
Idaho,Caldwell,59987,89,75,14
Idaho,Chubbuck,15773,35,22,13
Idaho,Coeur d'Alene,53405,114,92,22
Idaho,Cottonwood,944,1,1,0
Idaho,Emmett,7114,15,14,1
Idaho,Filer,2980,5,5,0
Idaho,Fruitland,5505,16,12,4
Idaho,Garden City,12084,36,28,8
Idaho,Gooding,3429,9,7,2
Idaho,Grangeville,3246,6,6,0
Idaho,Hailey,8778,13,12,1
Idaho,Heyburn,3489,8,7,1
Idaho,Homedale,2730,6,5,1
Idaho,Idaho City,470,1,1,0
Idaho,Idaho Falls,63457,134,89,45
Idaho,Jerome,12120,23,20,3
Idaho,Kellogg,2136,8,8,0
Idaho,Ketchum,2872,11,10,1
Idaho,Kimberly,4146,9,8,1
Idaho,Lewiston,32886,68,46,22
Idaho,McCall,3677,13,11,2
Idaho,Meridian,119203,154,124,30
Idaho,Middleton,8877,10,9,1
Idaho,Montpelier,2533,4,3,1
Idaho,Moscow,25918,41,34,7
Idaho,Mountain Home,14597,33,29,4
Idaho,Nampa,101411,185,128,57
Idaho,Orofino,3088,6,5,1
Idaho,Osburn,1557,2,2,0
Idaho,Parma,2167,5,5,0
Idaho,Payette,7753,16,14,2
Idaho,Pinehurst,1627,2,2,0
Idaho,Pocatello,56900,128,91,37
Idaho,Ponderay,1170,8,7,1
Idaho,Post Falls,37317,70,47,23
Idaho,Preston,5592,9,8,1
Idaho,Priest River,1911,6,5,1
Idaho,Rathdrum,9449,18,15,3
Idaho,Rexburg,29865,41,32,9
Idaho,Rigby,4332,8,7,1
Idaho,Rupert,5927,13,12,1
Idaho,Salmon,3171,9,9,0
Idaho,Sandpoint,9111,24,20,4
Idaho,Shelley,4470,8,8,0
Idaho,Shoshone,1504,6,6,0
Idaho,Soda Springs,3020,7,7,0
Idaho,Spirit Lake,2610,7,6,1
Idaho,St. Anthony,3552,6,6,0
Idaho,Sun Valley,1495,12,11,1
Idaho,Twin Falls,50872,94,75,19
Idaho,Weiser,5364,13,10,3
Idaho,Wilder,1858,4,4,0
Illinois,Abingdon,3026,6,6,0
Illinois,Addison,36411,127,63,64
Illinois,Albers,1130,2,1,1
Illinois,Algonquin,30990,51,44,7
Illinois,Alsip,18646,44,41,3
Illinois,Alton,26027,81,58,23
Illinois,Amboy,2301,2,2,0
Illinois,Antioch,14141,29,26,3
Illinois,Arlington Heights,74706,128,101,27
Illinois,Ashland,1176,1,1,0
Illinois,Assumption,1055,2,2,0
Illinois,Aurora,197709,352,291,61
Illinois,Aviston,2153,1,1,0
Illinois,Bannockburn,1508,7,7,0
Illinois,Barrington,10205,27,23,4
Illinois,Barrington Hills,4185,20,16,4
Illinois,Belleville,40537,93,72,21
Illinois,Bellwood,18629,43,39,4
Illinois,Bensenville,18009,36,32,4
Illinois,Bethany,1227,2,2,0
Illinois,Bloomingdale,21746,55,43,12
Illinois,Bolingbrook,74665,128,112,16
Illinois,Bourbonnais,19551,27,26,1
Illinois,Bradley,15251,37,34,3
Illinois,Bridgeview,16056,32,32,0
Illinois,Buffalo Grove,40380,74,58,16
Illinois,Burr Ridge,10782,31,27,4
Illinois,Cambridge,2069,1,1,0
Illinois,Campton Hills,11092,7,7,0
Illinois,Carbondale,24933,73,57,16
Illinois,Carlinville,5434,18,13,5
Illinois,Carlyle,3174,8,7,1
Illinois,Carpentersville,37201,61,57,4
Illinois,Cary,18036,26,25,1
Illinois,Centralia,12123,32,24,8
Illinois,Champaign,89785,134,113,21
Illinois,Channahon,13312,29,27,2
Illinois,Chatham,13152,21,15,6
Illinois,Chenoa,3110,4,4,0
Illinois,Chicago,2693598,13562,12727,835
Illinois,Chicago Heights,29207,86,74,12
Illinois,Chicago Ridge,13885,37,32,5
Illinois,Chillicothe,6004,12,12,0
Illinois,Cicero,80420,179,154,25
Illinois,Clarendon Hills,8787,14,13,1
Illinois,Collinsville,24261,61,43,18
Illinois,Cortland,4421,6,6,0
Illinois,Crest Hill,20328,31,29,2
Illinois,Crete,7996,20,18,2
Illinois,Crystal Lake,39726,76,67,9
Illinois,Danville,30208,74,62,12
Illinois,Deerfield,18692,55,41,14
Illinois,DeKalb,42710,71,57,14
Illinois,Des Plaines,58950,102,89,13
Illinois,Downers Grove,49070,84,67,17
Illinois,Dupo,3845,8,8,0
Illinois,Du Quoin,5624,14,10,4
Illinois,Dwight,3955,10,9,1
Illinois,Earlville,1575,4,3,1
Illinois,East Dundee,3260,13,12,1
Illinois,East Moline,20573,38,35,3
Illinois,Edwardsville,25327,59,44,15
Illinois,Effingham,12531,40,25,15
Illinois,Elburn,6043,9,8,1
Illinois,Elgin,111127,238,184,54
Illinois,Elk Grove Village,32290,97,83,14
Illinois,Elmhurst,47034,87,66,21
Illinois,Elmwood Park,24011,41,35,6
Illinois,Elwood,2220,11,10,1
Illinois,Evanston,73352,168,119,49
Illinois,Evergreen Park,19070,74,56,18
Illinois,Fairfield,4914,13,9,4
Illinois,Fairview Heights,16217,49,45,4
Illinois,Farmer City,1927,5,5,0
Illinois,Farmington,2200,6,6,0
Illinois,Flora,4829,18,12,6
Illinois,Flossmoor,9123,25,20,5
Illinois,Fox Lake,10426,33,28,5
Illinois,Frankfort,19551,36,33,3
Illinois,Freeport,23583,56,39,17
Illinois,Galena,3131,11,10,1
Illinois,Geneva,21831,44,35,9
Illinois,Genoa,5244,7,6,1
Illinois,Gibson City,3214,8,7,1
Illinois,Glencoe,8837,42,36,6
Illinois,Glendale Heights,33539,68,50,18
Illinois,Glen Ellyn,27704,47,39,8
Illinois,Glenwood,8685,26,23,3
Illinois,Golf,493,1,1,0
Illinois,Granite City,27982,70,57,13
Illinois,Greenfield,979,2,2,0
Illinois,Gurnee,30281,96,62,34
Illinois,Hanover Park,37350,81,58,23
Illinois,Havana,2954,14,9,5
Illinois,Henning,232,1,1,0
Illinois,Herscher,1494,3,3,0
Illinois,Hickory Hills,13672,38,27,11
Illinois,Highland,9819,26,19,7
Illinois,Hillside,7902,33,24,9
Illinois,Hinckley,2048,3,3,0
Illinois,Hodgkins,1979,23,21,2
Illinois,Homewood,18636,43,38,5
Illinois,Hoopeston,4972,19,10,9
Illinois,Hopedale,820,1,1,0
Illinois,Huntley,27566,41,36,5
Illinois,Island Lake,8014,14,13,1
Illinois,Itasca,9944,23,20,3
Illinois,Jacksonville,18515,37,33,4
Illinois,Joliet,147324,317,254,63
Illinois,Kankakee,25863,66,62,4
Illinois,Kenilworth,2471,9,8,1
Illinois,Kingston,1170,2,2,0
Illinois,Kirkland,1727,2,2,0
Illinois,La Grange,15295,29,25,4
Illinois,Lake Bluff,5548,16,14,2
Illinois,Lake Forest,19452,43,37,6
Illinois,Lake in the Hills,28598,47,39,8
Illinois,Lake Zurich,19895,47,30,17
Illinois,Lansing,27297,73,56,17
Illinois,Lemont,17432,27,22,5
Illinois,Lincoln,13417,29,27,2
Illinois,Lincolnshire,7962,27,25,2
Illinois,Lindenhurst,14174,14,12,2
Illinois,Lisle,23351,48,37,11
Illinois,Litchfield,6668,16,15,1
Illinois,Lombard,44392,74,62,12
Illinois,Loves Park,23303,39,37,2
Illinois,Lovington,1016,2,2,0
Illinois,Lyons,10332,19,16,3
Illinois,Mackinaw,1878,3,3,0
Illinois,Manteno,8980,20,19,1
Illinois,Maple Park,1371,1,1,0
Illinois,Marissa,1788,4,3,1
Illinois,Markham,12289,33,31,2
Illinois,Marseilles,4804,10,9,1
Illinois,Matteson,19494,54,36,18
Illinois,McHenry,27061,78,46,32
Illinois,Metropolis,5881,18,13,5
Illinois,Midlothian,14294,32,29,3
Illinois,Milan,4969,16,15,1
Illinois,Milledgeville,943,2,2,0
Illinois,Minier,1183,2,2,0
Illinois,Moline,41128,87,81,6
Illinois,Monee,5054,16,15,1
Illinois,Montgomery,19783,36,32,4
Illinois,Monticello,5532,9,7,2
Illinois,Morris,15216,31,27,4
Illinois,Morrison,3966,8,8,0
Illinois,Morton,16267,22,18,4
Illinois,Mount Carmel,6971,17,12,5
Illinois,Mount Pulaski,1454,2,2,0
Illinois,Mount Zion,5788,12,10,2
Illinois,Mundelein,31053,79,51,28
Illinois,Murphysboro,7345,23,15,8
Illinois,Naperville,149137,264,174,90
Illinois,Neoga,1598,3,3,0
Illinois,New Athens,1865,4,4,0
Illinois,New Lenox,27230,43,37,6
Illinois,Niles,28839,69,55,14
Illinois,Normal,54677,89,81,8
Illinois,North Pekin,1540,6,6,0
Illinois,North Riverside,6402,25,23,2
Illinois,Oak Brook,8029,49,41,8
Illinois,Oakbrook Terrace,2097,25,21,4
Illinois,Oak Park,52435,134,109,25
Illinois,Oakwood Hills,2023,4,3,1
Illinois,O'Fallon,29672,63,47,16
Illinois,Orion,1791,2,2,0
Illinois,Orland Park,57993,128,98,30
Illinois,Oswego,36934,60,49,11
Illinois,Ottawa,17983,52,36,16
Illinois,Palatine,67358,139,106,33
Illinois,Palestine,1263,2,2,0
Illinois,Palos Heights,12520,30,27,3
Illinois,Palos Hills,17013,33,30,3
Illinois,Palos Park,4723,11,10,1
Illinois,Pana,5327,13,8,5
Illinois,Park Ridge,36888,68,54,14
Illinois,Pawnee,2628,3,3,0
Illinois,Pekin,31834,61,53,8
Illinois,Peoria,109924,224,203,21
Illinois,Peoria Heights,5748,16,14,2
Illinois,Petersburg,2202,5,5,0
Illinois,Plano,11755,25,23,2
Illinois,Polo,2153,5,5,0
Illinois,Pontiac,11184,21,19,2
Illinois,Princeton,7420,18,16,2
Illinois,Prophetstown,1924,4,4,0
Illinois,Prospect Heights,15845,26,22,4
Illinois,Richmond,1908,5,5,0
Illinois,River Forest,10776,29,27,2
Illinois,River Grove,9843,30,26,4
Illinois,Riverton,3430,10,10,0
Illinois,Riverwoods,3550,7,7,0
Illinois,Rochelle,8998,30,21,9
Illinois,Rochester,3709,9,9,0
Illinois,Rockdale,1901,6,6,0
Illinois,Rockford,144795,332,289,43
Illinois,Rock Island,36981,99,75,24
Illinois,Round Lake,18069,29,26,3
Illinois,Roxana,1423,5,4,1
Illinois,Salem,6921,24,17,7
Illinois,San Jose,589,2,2,0
Illinois,Savanna,2769,7,7,0
Illinois,Shiloh,13701,21,20,1
Illinois,Silvis,7470,20,17,3
Illinois,Skokie,62462,151,109,42
Illinois,South Barrington,5044,22,19,3
Illinois,South Beloit,7594,14,13,1
Illinois,South Elgin,25084,39,35,4
Illinois,South Holland,21218,49,46,3
Illinois,Springfield,113912,257,229,28
Illinois,Spring Grove,5698,8,7,1
Illinois,Spring Valley,5081,12,11,1
Illinois,St. Charles,32949,67,57,10
Illinois,St. Elmo,1397,3,3,0
Illinois,Sterling,14361,34,27,7
Illinois,Streator,13019,26,22,4
Illinois,Sumner,2959,2,2,0
Illinois,Sycamore,18413,30,28,2
Illinois,Taylorville,10264,20,20,0
Illinois,Thayer,651,1,1,0
Illinois,Trenton,2576,5,5,0
Illinois,University Park,6861,18,16,2
Illinois,Urbana,42211,70,58,12
Illinois,Vandalia,6647,12,12,0
Illinois,Vernon Hills,26693,65,40,25
Illinois,Villa Park,21421,45,36,9
Illinois,Waterloo,10645,19,18,1
Illinois,Watseka,4713,12,11,1
Illinois,Wauconda,13488,27,25,2
Illinois,Waukegan,85739,188,146,42
Illinois,West Chicago,26768,46,41,5
Illinois,West Dundee,8215,20,18,2
Illinois,Westmont,24416,40,35,5
Illinois,Wheaton,52706,83,68,15
Illinois,Wheeling,38753,84,55,29
Illinois,White Hall,2309,10,6,4
Illinois,Willow Springs,5606,10,9,1
Illinois,Winfield,9693,19,16,3
Illinois,Winnetka,12328,32,26,6
Illinois,Wood Dale,13588,43,34,9
Illinois,Woodstock,25283,42,39,3
Illinois,Worth,10430,27,25,2
Illinois,Yorkville,21052,33,30,3
Indiana,Anderson,54623,113,95,18
Indiana,Angola,8748,23,19,4
Indiana,Auburn,13560,26,23,3
Indiana,Austin,4100,9,9,0
Indiana,Bargersville,8342,13,12,1
Indiana,Bedford,13192,39,31,8
Indiana,Bluffton,10173,32,20,12
Indiana,Brownsburg,27621,57,51,6
Indiana,Carmel,103100,153,128,25
Indiana,Cedar Lake,13372,20,18,2
Indiana,Chesterton,14203,26,22,4
Indiana,Columbus,48505,22,21,1
Indiana,Crawfordsville,16137,45,40,5
Indiana,Cumberland,6097,18,16,2
Indiana,Danville,10247,20,18,2
Indiana,Dyer,15932,35,32,3
Indiana,Edinburgh,4603,13,12,1
Indiana,Ellettsville,6804,12,11,1
Indiana,Elwood,8372,18,17,1
Indiana,Evansville,117747,310,283,27
Indiana,Fairmount,2749,7,6,1
Indiana,Fort Wayne,272270,538,474,64
Indiana,Franklin,25825,60,54,6
Indiana,Gas City,5732,11,11,0
Indiana,Goshen,34409,72,64,8
Indiana,Greenfield,23273,45,41,4
Indiana,Greenwood,60460,71,63,8
Indiana,Hammond,74966,241,204,37
Indiana,Hartford City,5606,11,10,1
Indiana,Highland,22165,43,37,6
Indiana,Hobart,27791,78,67,11
Indiana,Huntingburg,6182,15,14,1
Indiana,Huntington,17096,36,33,3
Indiana,Indianapolis,890672,2656,2086,570
Indiana,Jasper,15790,31,23,8
Indiana,Kendallville,9897,28,19,9
Indiana,Lafayette,72040,184,132,52
Indiana,La Porte,21515,46,42,4
Indiana,Lawrence,49865,81,61,20
Indiana,Lebanon,16097,42,40,2
Indiana,Linton,5179,15,9,6
Indiana,Mount Vernon,6471,15,15,0
Indiana,Muncie,67760,109,95,14
Indiana,Munster,22357,46,41,5
Indiana,Nappanee,6864,21,18,3
Indiana,New Haven,16044,31,23,8
Indiana,New Palestine,2615,7,7,0
Indiana,New Whiteland,6332,8,7,1
Indiana,Noblesville,66127,99,89,10
Indiana,North Webster,1170,5,5,0
Indiana,Pittsboro,3698,9,8,1
Indiana,Plainfield,36239,65,59,6
Indiana,Porter,4832,14,11,3
Indiana,Richmond,35192,82,72,10
Indiana,Roseland,636,4,3,1
Indiana,Schererville,28454,67,52,15
Indiana,Shelbyville,19451,58,45,13
Indiana,Shirley,892,2,2,0
Indiana,South Bend,102119,272,224,48
Indiana,Speedway,12235,50,35,15
Indiana,St. John,19289,25,23,2
Indiana,Terre Haute,60604,141,132,9
Indiana,Valparaiso,34139,63,57,6
Indiana,Walkerton,2269,10,6,4
Indiana,Washington,12612,28,21,7
Indiana,West Lafayette,52104,65,46,19
Indiana,Winchester,4634,13,13,0
Indiana,Zionsville,28824,37,35,2
Iowa,Ackley,1488,2,2,0
Iowa,Adel,5696,12,11,1
Iowa,Albia,3670,7,6,1
Iowa,Algona,5380,14,10,4
Iowa,Altoona,19804,37,35,2
Iowa,Ames,67109,79,55,24
Iowa,Anamosa,5536,9,8,1
Iowa,Ankeny,70301,72,62,10
Iowa,Asbury,5909,5,5,0
Iowa,Atlantic,6465,13,12,1
Iowa,Audubon,1871,4,4,0
Iowa,Belle Plaine,2430,5,5,0
Iowa,Belmond,2252,5,5,0
Iowa,Bettendorf,36926,51,45,6
Iowa,Bloomfield,2683,6,5,1
Iowa,Blue Grass,1686,4,3,1
Iowa,Boone,12355,18,17,1
Iowa,Burlington,24622,50,44,6
Iowa,Camanche,4356,9,9,0
Iowa,Carlisle,4341,9,8,1
Iowa,Carroll,9800,16,15,1
Iowa,Carter Lake,3784,11,10,1
Iowa,Cedar Falls,40675,67,66,1
Iowa,Cedar Rapids,134330,282,219,63
Iowa,Centerville,5425,17,10,7
Iowa,Charles City,7269,21,14,7
Iowa,Cherokee,4826,7,6,1
Iowa,Clarinda,5343,9,8,1
Iowa,Clarion,2695,6,6,0
Iowa,Clear Lake,7526,22,15,7
Iowa,Clinton,24905,53,47,6
Iowa,Clive,17447,33,29,4
Iowa,Colfax,2061,4,4,0
Iowa,Coralville,22699,37,33,4
Iowa,Council Bluffs,62144,134,115,19
Iowa,Creston,7701,16,12,4
Iowa,Davenport,101806,189,167,22
Iowa,Dayton,769,1,1,0
Iowa,Decorah,7516,14,13,1
Iowa,Denison,8234,20,13,7
Iowa,Des Moines,215290,464,367,97
Iowa,DeWitt,5178,11,10,1
Iowa,Dubuque,57904,110,102,8
Iowa,Durant,1864,4,4,0
Iowa,Dyersville,4357,7,7,0
Iowa,Dysart,1307,2,2,0
Iowa,Eagle Grove,3388,5,5,0
Iowa,Eldora,2599,5,5,0
Iowa,Eldridge,6991,10,9,1
Iowa,Emmetsburg,3661,7,6,1
Iowa,Estherville,5595,11,11,0
Iowa,Evansdale,4742,8,7,1
Iowa,Fairfield,10538,20,13,7
Iowa,Forest City,4013,9,8,1
Iowa,Fort Dodge,23755,44,40,4
Iowa,Fort Madison,10239,19,17,2
Iowa,Glenwood,5402,11,10,1
Iowa,Gowrie,944,1,1,0
Iowa,Grinnell,9104,13,11,2
Iowa,Grundy Center,2666,5,5,0
Iowa,Hampton,4176,8,7,1
Iowa,Harlan,4732,9,8,1
Iowa,Hawarden,2434,4,4,0
Iowa,Hiawatha,7465,16,16,0
Iowa,Humboldt,4577,6,6,0
Iowa,Huxley,4124,6,6,0
Iowa,Independence,6141,11,9,2
Iowa,Indianola,16154,24,21,3
Iowa,Iowa City,75964,103,81,22
Iowa,Iowa Falls,5034,14,10,4
Iowa,Jefferson,4075,7,7,0
Iowa,Johnston,23252,35,30,5
Iowa,Keokuk,10091,27,23,4
Iowa,Knoxville,7155,15,13,2
Iowa,Lake City,1633,3,3,0
Iowa,Lansing,928,3,3,0
Iowa,Le Claire,3990,8,7,1
Iowa,Le Mars,10110,17,15,2
Iowa,Leon,1808,3,3,0
Iowa,Lisbon,2259,2,2,0
Iowa,Manchester,4965,16,10,6
Iowa,Maquoketa,5966,18,11,7
Iowa,Marengo,2460,3,3,0
Iowa,Marion,40968,60,46,14
Iowa,Marshalltown,26564,42,37,5
Iowa,Mason City,26811,45,39,6
Iowa,Mechanicsville,1127,1,1,0
Iowa,Monticello,3891,8,7,1
Iowa,Mount Pleasant,8670,16,14,2
Iowa,Mount Vernon,4463,7,6,1
Iowa,Muscatine,23616,43,39,4
Iowa,Nevada,6662,11,9,2
Iowa,New Hampton,3389,6,6,0
Iowa,Newton,15176,32,27,5
Iowa,North Liberty,20294,24,22,2
Iowa,Norwalk,12313,20,19,1
Iowa,Oelwein,5846,14,10,4
Iowa,Ogden,1972,2,2,0
Iowa,Onawa,2739,5,5,0
Iowa,Orange City,6195,7,7,0
Iowa,Osage,3548,7,6,1
Iowa,Osceola,5275,12,11,1
Iowa,Oskaloosa,11505,16,14,2
Iowa,Ottumwa,24293,50,38,12
Iowa,Pella,10225,24,18,6
Iowa,Perry,7669,19,12,7
Iowa,Pleasant Hill,10158,22,20,2
Iowa,Polk City,5165,7,7,0
Iowa,Postville,2034,4,4,0
Iowa,Prairie City,1723,2,2,0
Iowa,Princeton,953,1,1,0
Iowa,Red Oak,5230,12,10,2
Iowa,Rock Valley,3899,6,6,0
Iowa,Sac City,2051,4,4,0
Iowa,Sergeant Bluff,5226,9,8,1
Iowa,Sheldon,5069,6,6,0
Iowa,Shenandoah,4786,10,9,1
Iowa,Sigourney,2013,2,1,1
Iowa,Sioux Center,7669,8,8,0
Iowa,Sioux City,82628,150,125,25
Iowa,Spencer,10922,30,20,10
Iowa,Spirit Lake,5189,11,10,1
Iowa,State Center,1432,2,2,0
Iowa,Storm Lake,10282,24,20,4
Iowa,Story City,3307,5,5,0
Iowa,Tama,2717,6,6,0
Iowa,Tipton,3224,7,6,1
Iowa,Toledo,2123,6,6,0
Iowa,University Heights,1025,5,5,0
Iowa,Urbandale,44959,60,51,9
Iowa,Van Meter,1324,2,2,0
Iowa,Vinton,5056,10,9,1
Iowa,Walcott,1636,3,3,0
Iowa,Washington,7227,12,11,1
Iowa,Waterloo,67200,128,119,9
Iowa,Waukee,25590,30,26,4
Iowa,Waukon,3594,5,4,1
Iowa,Waverly,10234,15,14,1
Iowa,Webster City,7630,19,12,7
Iowa,West Branch,2510,4,4,0
Iowa,West Burlington,2878,10,10,0
Iowa,West Des Moines,69252,102,89,13
Iowa,West Liberty,3768,6,6,0
Iowa,Williamsburg,3175,7,7,0
Iowa,Wilton,2828,4,4,0
Iowa,Windsor Heights,4798,13,12,1
Iowa,Winterset,5403,8,8,0
Kansas,Abilene,6133,17,14,3
Kansas,Altamont,1012,3,3,0
Kansas,Andover,13592,34,26,8
Kansas,Anthony,2051,4,3,1
Kansas,Arkansas City,11589,31,27,4
Kansas,Arma,1413,5,5,0
Kansas,Atchison,10421,25,24,1
Kansas,Attica,550,1,1,0
Kansas,Augusta,9339,32,25,7
Kansas,Baldwin City,4720,13,11,2
Kansas,Basehor,6742,17,15,2
Kansas,Baxter Springs,3915,9,8,1
Kansas,Bel Aire,8490,11,10,1
Kansas,Belle Plaine,1543,5,5,0
Kansas,Beloit,3604,8,7,1
Kansas,Benton,869,2,2,0
Kansas,Blue Rapids,955,2,2,0
Kansas,Bonner Springs,7955,26,23,3
Kansas,Buhler,1272,3,3,0
Kansas,Burden,525,2,2,0
Kansas,Burlingame,898,2,2,0
Kansas,Burlington,2530,9,7,2
Kansas,Burrton,855,2,2,0
Kansas,Caldwell,978,3,3,0
Kansas,Caney,1943,11,6,5
Kansas,Canton,689,1,1,0
Kansas,Carbondale,1362,3,3,0
Kansas,Cedar Vale,501,1,1,0
Kansas,Chanute,9034,20,18,2
Kansas,Chapman,1332,3,3,0
Kansas,Chase,434,1,1,0
Kansas,Cheney,2174,6,6,0
Kansas,Cherokee,708,1,1,0
Kansas,Cherryvale,2114,6,5,1
Kansas,Chetopa,1007,4,4,0
Kansas,Claflin,596,1,1,0
Kansas,Clay Center,3944,8,7,1
Kansas,Clearwater,2559,7,6,1
Kansas,Coffeyville,9171,32,24,8
Kansas,Colby,5365,19,13,6
Kansas,Coldwater,727,1,1,0
Kansas,Columbus,3025,9,8,1
Kansas,Colwich,1483,3,3,0
Kansas,Conway Springs,1212,4,4,0
Kansas,Council Grove,2112,8,7,1
Kansas,Derby,25229,57,48,9
Kansas,Dodge City,27066,54,42,12
Kansas,Eastborough,729,6,6,0
Kansas,Edwardsville,4503,18,17,1
Kansas,El Dorado,12924,23,20,3
Kansas,Elkhart,1714,3,3,0
Kansas,Ellinwood,1923,5,5,0
Kansas,Ellis,2004,4,4,0
Kansas,Ellsworth,2943,7,6,1
Kansas,Elwood,1188,3,3,0
Kansas,Emporia,24564,48,41,7
Kansas,Eudora,6440,12,12,0
Kansas,Fairway,3970,9,9,0
Kansas,Fredonia,2199,7,6,1
Kansas,Frontenac,3382,10,7,3
Kansas,Galena,2832,10,8,2
Kansas,Galva,876,1,1,0
Kansas,Garden City,26360,86,60,26
Kansas,Gardner,22370,39,34,5
Kansas,Garnett,3216,7,7,0
Kansas,Girard,2659,7,6,1
Kansas,Goddard,4840,13,12,1
Kansas,Goodland,4397,9,8,1
Kansas,Grandview Plaza,1503,8,7,1
Kansas,Great Bend,14864,34,30,4
Kansas,Hays,20769,8,7,1
Kansas,Haysville,11395,29,23,6
Kansas,Herington,2241,8,7,1
Kansas,Hesston,3744,8,7,1
Kansas,Hiawatha,3103,11,10,1
Kansas,Highland,992,1,1,0
Kansas,Hill City,1403,4,4,0
Kansas,Hillsboro,2796,5,5,0
Kansas,Hoisington,2446,7,6,1
Kansas,Holcomb,2070,2,1,1
Kansas,Holton,3196,6,6,0
Kansas,Holyrood,411,1,1,0
Kansas,Hoxie,1193,2,2,0
Kansas,Hugoton,3724,8,6,2
Kansas,Hutchinson,40186,96,65,31
Kansas,Independence,8405,26,19,7
Kansas,Inman,1328,4,4,0
Kansas,Iola,5220,18,17,1
Kansas,Junction City,21242,69,45,24
Kansas,Kanopolis,448,1,1,0
Kansas,Kechi,2015,5,4,1
Kansas,Kingman,2807,7,7,0
Kansas,Kiowa,921,1,1,0
Kansas,La Cygne,1116,2,2,0
Kansas,Lake Quivira,936,1,1,0
Kansas,Lansing,12023,17,16,1
Kansas,Larned,3632,6,6,0
Kansas,Lawrence,99368,169,143,26
Kansas,Leavenworth,36023,72,55,17
Kansas,Leawood,35054,81,60,21
Kansas,Lebo,882,1,1,0
Kansas,Lenexa,56508,135,87,48
Kansas,Liberal,19028,48,38,10
Kansas,Lindsborg,3273,8,7,1
Kansas,Little River,519,1,1,0
Kansas,Louisburg,4590,12,11,1
Kansas,Lyndon,1017,1,1,0
Kansas,Lyons,3478,7,6,1
Kansas,Macksville,528,1,1,0
Kansas,Marion,1759,5,5,0
Kansas,Marquette,594,1,1,0
Kansas,Marysville,3265,9,8,1
Kansas,McLouth,845,1,1,0
Kansas,McPherson,13053,40,32,8
Kansas,Meade,1502,4,3,1
Kansas,Medicine Lodge,1816,4,4,0
Kansas,Merriam,11087,36,31,5
Kansas,Minneapolis,1885,5,5,0
Kansas,Mission,9979,30,27,3
Kansas,Mission Hills,3555,3,3,0
Kansas,Moran,505,1,1,0
Kansas,Mound City,676,1,1,0
Kansas,Moundridge,1869,4,4,0
Kansas,Mount Hope,800,2,2,0
Kansas,Mulberry,521,1,1,0
Kansas,Mulvane,6528,21,14,7
Kansas,Neodesha,2239,8,7,1
Kansas,Newton,18830,42,38,4
Kansas,North Newton,1761,4,4,0
Kansas,Oakley,2077,9,5,4
Kansas,Oberlin,1691,5,5,0
Kansas,Olathe,142228,211,184,27
Kansas,Osage City,2795,7,7,0
Kansas,Oswego,1663,5,5,0
Kansas,Ottawa,12212,28,23,5
Kansas,Overland Park,198036,325,257,68
Kansas,Oxford,994,3,3,0
Kansas,Paola,5730,21,15,6
Kansas,Parsons,9373,29,21,8
Kansas,Peabody,1090,2,2,0
Kansas,Pleasanton,1157,3,3,0
Kansas,Prairie Village,22390,61,47,14
Kansas,Pratt,6460,20,15,5
Kansas,Roeland Park,6683,17,15,2
Kansas,Rose Hill,3972,9,8,1
Kansas,Russell,4412,9,8,1
Kansas,Salina,46400,108,81,27
Kansas,Scott City,3738,13,8,5
Kansas,Sedgwick,1654,2,2,0
Kansas,Seneca,2083,4,4,0
Kansas,Shawnee,66208,109,89,20
Kansas,Smith Center,1559,2,2,0
Kansas,Spearville,785,1,1,0
Kansas,Spring Hill,7572,13,12,1
Kansas,Sterling,2195,5,5,0
Kansas,St. George,1049,2,2,0
Kansas,St. Marys,2656,6,6,0
Kansas,Topeka,125024,330,285,45
Kansas,Troy,954,1,1,0
Kansas,Ulysses,5546,11,10,1
Kansas,Valley Center,7383,18,16,2
Kansas,WaKeeney,1751,5,5,0
Kansas,Wamego,4769,13,8,5
Kansas,Wathena,1287,2,2,0
Kansas,Wellington,7608,19,16,3
Kansas,Wellsville,1773,6,5,1
Kansas,Westwood,1657,8,7,1
Kansas,Winfield,11900,27,22,5
Kansas,Yates Center,1311,4,4,0
Kentucky,Adairville,883,1,1,0
Kentucky,Alexandria,9861,21,17,4
Kentucky,Anchorage,2431,14,10,4
Kentucky,Ashland,19979,51,48,3
Kentucky,Auburn,1384,2,2,0
Kentucky,Augusta,1143,2,2,0
Kentucky,Bancroft,514,1,1,0
Kentucky,Bardstown,13330,34,31,3
Kentucky,Beattyville,1212,6,6,0
Kentucky,Beaver Dam,3578,6,6,0
Kentucky,Bellefonte,816,5,5,0
Kentucky,Bellevue,5695,12,11,1
Kentucky,Berea,16311,38,33,5
Kentucky,Bloomfield,1071,1,1,0
Kentucky,Bowling Green,71861,159,120,39
Kentucky,Brandenburg,2898,5,5,0
Kentucky,Burkesville,1456,10,6,4
Kentucky,Burnside,844,5,5,0
Kentucky,Calvert City,2497,8,7,1
Kentucky,Carrollton,3763,15,14,1
Kentucky,Catlettsburg,1734,7,7,0
Kentucky,Cave City,2439,9,9,0
Kentucky,Central City,5703,12,12,0
Kentucky,Clay,1087,2,2,0
Kentucky,Clay City,1090,3,3,0
Kentucky,Cloverport,1152,1,1,0
Kentucky,Coal Run Village,1501,4,3,1
Kentucky,Cold Spring,6641,14,14,0
Kentucky,Columbia,4609,16,15,1
Kentucky,Corbin,7190,30,24,6
Kentucky,Covington,40324,121,110,11
Kentucky,Danville,16826,31,29,2
Kentucky,Dayton,5639,12,11,1
Kentucky,Eddyville,2544,3,3,0
Kentucky,Edgewood,8776,17,17,0
Kentucky,Edmonton,1593,7,7,0
Kentucky,Elizabethtown,30505,80,60,20
Kentucky,Elkton,2127,8,7,1
Kentucky,Elsmere,8618,15,15,0
Kentucky,Eminence,2591,6,6,0
Kentucky,Erlanger,23441,46,44,2
Kentucky,Eubank,331,1,1,0
Kentucky,Falmouth,2091,8,7,1
Kentucky,Flatwoods,7041,12,12,0
Kentucky,Florence,33397,68,66,2
Kentucky,Fort Mitchell,8249,13,13,0
Kentucky,Fort Thomas,16273,31,23,8
Kentucky,Fort Wright,5752,14,14,0
Kentucky,Frankfort,27803,59,57,2
Kentucky,Franklin,9072,24,23,1
Kentucky,Georgetown,35702,82,57,25
Kentucky,Glasgow,14537,45,37,8
Kentucky,Grayson,3870,11,10,1
Kentucky,Greenville,4174,12,11,1
Kentucky,Guthrie,1408,3,3,0
Kentucky,Hardinsburg,2338,5,5,0
Kentucky,Harlan,1480,15,10,5
Kentucky,Harrodsburg,8553,25,18,7
Kentucky,Hawesville,991,1,1,0
Kentucky,Heritage Creek,1139,11,11,0
Kentucky,Highland Heights,7069,12,11,1
Kentucky,Hillview,9311,20,20,0
Kentucky,Hodgenville,3251,8,8,0
Kentucky,Hopkinsville,30532,103,69,34
Kentucky,Hustonville,368,1,1,0
Kentucky,Hyden,328,1,1,0
Kentucky,Independence,28957,36,34,2
Kentucky,Indian Hills,2978,8,8,0
Kentucky,Irvine,2279,5,5,0
Kentucky,Jackson,1913,12,8,4
Kentucky,Jamestown,1791,4,4,0
Kentucky,Jeffersontown,27700,67,54,13
Kentucky,Jenkins,1899,4,4,0
Kentucky,Junction City,2312,3,3,0
Kentucky,La Grange,9142,17,15,2
Kentucky,Lakeside Park-Crestview Hills,6134,13,12,1
Kentucky,Lancaster,3873,12,12,0
Kentucky,Lawrenceburg,11565,21,14,7
Kentucky,Lebanon,5726,25,17,8
Kentucky,Leitchfield,6880,21,20,1
Kentucky,Lewisburg,803,1,1,0
Kentucky,Lexington,325851,670,580,90
Kentucky,Louisa,2313,6,6,0
Kentucky,Louisville Metro,673730,1388,1124,264
Kentucky,Loyall,592,2,2,0
Kentucky,Ludlow,4499,12,11,1
Kentucky,Madisonville,18494,59,46,13
Kentucky,Manchester,1274,11,11,0
Kentucky,Marion,2821,9,6,3
Kentucky,Martin,547,2,2,0
Kentucky,Mayfield,9791,26,25,1
Kentucky,Maysville,8695,36,26,10
Kentucky,Middlesboro,8968,26,21,5
Kentucky,Middletown,7910,17,16,1
Kentucky,Millersburg,779,2,2,0
Kentucky,Monticello,5966,9,9,0
Kentucky,Morehead,7644,28,19,9
Kentucky,Morganfield,3350,5,5,0
Kentucky,Mount Sterling,7268,23,21,2
Kentucky,Mount Washington,14964,27,25,2
Kentucky,Muldraugh,991,3,3,0
Kentucky,Murray,19499,48,40,8
Kentucky,Newport,14874,44,40,4
Kentucky,Nicholasville,31191,74,67,7
Kentucky,Oak Grove,7299,16,16,0
Kentucky,Olive Hill,1548,8,7,1
Kentucky,Owensboro,60430,125,93,32
Kentucky,Owingsville,1580,5,5,0
Kentucky,Paducah,24850,97,69,28
Kentucky,Paintsville,3964,9,8,1
Kentucky,Park Hills,2983,8,8,0
Kentucky,Pewee Valley,1585,1,1,0
Kentucky,Pikeville,6501,32,23,9
Kentucky,Pineville,1709,7,7,0
Kentucky,Pioneer Village,2967,5,5,0
Kentucky,Pippa Passes,671,7,1,6
Kentucky,Powderly,735,3,2,1
Kentucky,Prestonsburg,3500,18,13,5
Kentucky,Prospect,4929,8,7,1
Kentucky,Providence,2979,5,5,0
Kentucky,Radcliff,22950,45,34,11
Kentucky,Ravenna,554,1,1,0
Kentucky,Richmond,36691,70,61,9
Kentucky,Russell,3208,12,12,0
Kentucky,Russell Springs,2661,10,9,1
Kentucky,Russellville,7125,25,24,1
Kentucky,Science Hill,696,3,3,0
Kentucky,Scottsville,4576,26,16,10
Kentucky,Sebree,1523,1,1,0
Kentucky,Shelbyville,16863,31,30,1
Kentucky,Shepherdsville,12567,38,36,2
Kentucky,Shively,15735,36,30,6
Kentucky,Simpsonville,2974,10,10,0
Kentucky,Smiths Grove,807,1,1,0
Kentucky,Somerset,11622,52,47,5
Kentucky,Southgate,4039,8,8,0
Kentucky,South Shore,1050,1,1,0
Kentucky,Springfield,2980,15,8,7
Kentucky,Stamping Ground,819,2,2,0
Kentucky,Stanton,2701,8,8,0
Kentucky,St. Matthews,18162,43,37,6
Kentucky,Tompkinsville,2242,10,7,3
Kentucky,Trenton,374,1,1,0
Kentucky,Vanceburg,1393,5,5,0
Kentucky,Versailles,26899,35,34,1
Kentucky,Villa Hills,7478,14,14,0
Kentucky,Vine Grove,6596,11,11,0
Kentucky,Warsaw,1705,4,4,0
Kentucky,West Buechel,1277,11,11,0
Kentucky,West Point,870,3,3,0
Kentucky,Whitesburg,1813,6,5,1
Kentucky,Wilder,3058,10,10,0
Kentucky,Williamstown,3907,7,6,1
Kentucky,Wilmore,6496,9,8,1
Kentucky,Winchester,18570,47,31,16
Louisiana,Abbeville,12018,37,34,3
Louisiana,Alexandria,45986,159,127,32
Louisiana,Baker,13122,36,34,2
Louisiana,Basile,1779,9,8,1
Louisiana,Bastrop,9889,22,22,0
Louisiana,Bernice,1583,3,3,0
Louisiana,Berwick,4365,14,13,1
Louisiana,Bossier City,68869,200,161,39
Louisiana,Breaux Bridge,8149,29,26,3
Louisiana,Broussard,13299,37,33,4
Louisiana,Carencro,9668,30,28,2
Louisiana,Church Point,4336,16,16,0
Louisiana,Crowley,12515,38,32,6
Louisiana,De Ridder,10583,27,26,1
Louisiana,Dixie Inn,261,2,2,0
Louisiana,Erath,2031,11,7,4
Louisiana,Eunice,9751,40,29,11
Louisiana,Gonzales,11092,48,43,5
Louisiana,Haughton,3278,14,13,1
Louisiana,Iowa,3184,18,14,4
Louisiana,Jennings,9737,27,21,6
Louisiana,Kaplan,4402,20,14,6
Louisiana,Kinder,2357,15,11,4
Louisiana,Lafayette,126679,327,275,52
Louisiana,Lake Charles,79077,174,140,34
Louisiana,Mansfield,4587,22,16,6
Louisiana,Marksville,5299,24,17,7
Louisiana,Minden,11711,29,28,1
Louisiana,Monroe,47119,158,123,35
Louisiana,Opelousas,15820,58,45,13
Louisiana,Patterson,5758,25,25,0
Louisiana,Pineville,14079,77,69,8
Louisiana,Plaquemine,6479,29,20,9
Louisiana,Port Allen,4695,21,20,1
Louisiana,Rayne,7997,24,23,1
Louisiana,Rayville,3450,10,10,0
Louisiana,Ruston,21846,49,37,12
Louisiana,Scott,8696,30,28,2
Louisiana,Springhill,4720,19,14,5
Louisiana,Sterlington,3135,3,3,0
Louisiana,Sulphur,20029,65,52,13
Louisiana,Tallulah,6596,13,7,6
Louisiana,Thibodaux,14418,62,42,20
Louisiana,Tickfaw,772,5,5,0
Louisiana,Vidalia,3765,33,25,8
Louisiana,Ville Platte,6991,24,17,7
Louisiana,Welsh,3227,14,14,0
Louisiana,Westlake,4997,17,14,3
Louisiana,West Monroe,12134,64,49,15
Louisiana,Winnfield,4201,22,14,8
Louisiana,Youngsville,15654,34,30,4
Maine,Ashland,1208,3,3,0
Maine,Auburn,23455,59,52,7
Maine,Augusta,18653,56,45,11
Maine,Baileyville,1439,5,5,0
Maine,Bangor,32179,97,81,16
Maine,Bar Harbor,7716,28,20,8
Maine,Bath,8322,24,19,5
Maine,Belfast,6681,17,16,1
Maine,Berwick,7944,13,12,1
Maine,Biddeford,21530,84,57,27
Maine,Boothbay Harbor,2219,9,8,1
Maine,Brewer,8988,23,21,2
Maine,Bridgton,5459,10,9,1
Maine,Brunswick,20566,47,32,15
Maine,Bucksport,4927,13,10,3
Maine,Buxton,8360,14,8,6
Maine,Calais,2993,7,7,0
Maine,Camden,4776,12,11,1
Maine,Cape Elizabeth,9340,15,14,1
Maine,Caribou,7532,15,14,1
Maine,Carrabassett Valley,788,1,1,0
Maine,Clinton,3340,4,4,0
Maine,Cumberland,8327,14,12,2
Maine,Damariscotta,2144,6,5,1
Maine,Dexter,3687,6,6,0
Maine,Dover-Foxcroft,4018,5,5,0
Maine,East Millinocket,2922,5,5,0
Maine,Eastport,1258,1,1,0
Maine,Eliot,6990,8,7,1
Maine,Ellsworth,8231,22,19,3
Maine,Fairfield,6531,12,12,0
Maine,Falmouth,12444,28,19,9
Maine,Farmington,7764,12,11,1
Maine,Fort Fairfield,3263,2,2,0
Maine,Fort Kent,3831,9,4,5
Maine,Freeport,8637,18,16,2
Maine,Fryeburg,3452,5,5,0
Maine,Gardiner,5639,14,13,1
Maine,Gorham,18167,25,22,3
Maine,Gouldsboro,1742,2,2,0
Maine,Greenville,1599,3,3,0
Maine,Hallowell,2382,5,5,0
Maine,Hampden,7428,11,11,0
Maine,Holden,3106,4,4,0
Maine,Houlton,5713,15,10,5
Maine,Islesboro,560,1,1,0
Maine,Jay,4600,8,7,1
Maine,Kennebunk,11719,26,23,3
Maine,Kennebunkport,3671,18,13,5
Maine,Kittery,9855,29,22,7
Maine,Lewiston,36186,93,80,13
Maine,Limestone,2159,3,3,0
Maine,Lincoln,4838,6,5,1
Maine,Lisbon,9004,18,13,5
Maine,Livermore Falls,3154,6,6,0
Maine,Machias,2007,3,3,0
Maine,Madawaska,3704,7,6,1
Maine,Mechanic Falls,2974,6,6,0
Maine,Mexico,2624,5,5,0
Maine,Milbridge,1288,1,1,0
Maine,Millinocket,4226,7,6,1
Maine,Milo,2279,3,3,0
Maine,Monmouth,4139,4,4,0
Maine,Newport,3272,6,6,0
Maine,North Berwick,4744,9,8,1
Maine,Norway,4989,10,9,1
Maine,Oakland,6317,11,10,1
Maine,Ogunquit,932,12,11,1
Maine,Old Orchard Beach,9061,25,22,3
Maine,Old Town,7388,16,15,1
Maine,Orono,10851,15,14,1
Maine,Oxford,4095,8,7,1
Maine,Paris,5149,9,8,1
Maine,Phippsburg,2274,1,1,0
Maine,Pittsfield,3971,7,6,1
Maine,Portland,66229,203,148,55
Maine,Presque Isle,8937,19,14,5
Maine,Rangeley,1153,3,3,0
Maine,Richmond,3477,4,4,0
Maine,Rockland,7151,19,17,2
Maine,Rockport,3367,6,6,0
Maine,Rumford,5735,13,12,1
Maine,Sabattus,5054,9,8,1
Maine,Saco,20133,47,31,16
Maine,Sanford,21272,43,39,4
Maine,Scarborough,21237,59,39,20
Maine,Searsport,2635,3,3,0
Maine,Skowhegan,8202,17,16,1
Maine,South Berwick,7605,11,10,1
Maine,South Portland,25593,62,53,9
Maine,Southwest Harbor,1795,8,4,4
Maine,Thomaston,2741,5,5,0
Maine,Topsham,8891,15,14,1
Maine,Veazie,1823,4,4,0
Maine,Waldoboro,5070,7,7,0
Maine,Washburn,1526,2,2,0
Maine,Waterville,16654,41,30,11
Maine,Wells,10803,33,24,9
Maine,Westbrook,19256,43,39,4
Maine,Wilton,3944,4,4,0
Maine,Windham,18720,30,27,3
Maine,Winslow,7599,11,10,1
Maine,Winter Harbor,511,1,1,0
Maine,Winthrop,5983,14,9,5
Maine,Wiscasset,3767,4,3,1
Maine,Yarmouth,8617,15,14,1
Maine,York,13377,37,26,11
Maryland,Aberdeen,16140,54,41,13
Maryland,Annapolis,39315,146,115,31
Maryland,Baltimore,588594,2940,2465,475
Maryland,Baltimore City Sheriff,,183,122,61
Maryland,Bel Air,10116,41,31,10
Maryland,Berlin,4914,19,14,5
Maryland,Berwyn Heights,3269,11,10,1
Maryland,Bladensburg,9455,34,23,11
Maryland,Boonsboro,3677,5,4,1
Maryland,Bowie,59008,80,63,17
Maryland,Brentwood,3485,4,3,1
Maryland,Brunswick,6562,16,16,0
Maryland,Cambridge,12239,42,39,3
Maryland,Capitol Heights,4537,13,11,2
Maryland,Centreville,5026,11,11,0
Maryland,Chestertown,5027,12,11,1
Maryland,Cheverly,6456,16,13,3
Maryland,Chevy Chase Village,2067,17,11,6
Maryland,Colmar Manor,1459,5,4,1
Maryland,Cottage City,1361,5,4,1
Maryland,Crisfield,2548,14,10,4
Maryland,Cumberland,19122,63,48,15
Maryland,Delmar,3384,13,12,1
Maryland,Denton,4525,13,12,1
Maryland,District Heights,6010,10,9,1
Maryland,Edmonston,1497,6,5,1
Maryland,Elkton,15639,45,39,6
Maryland,Fairmount Heights,1530,1,1,0
Maryland,Federalsburg,2653,10,9,1
Maryland,Forest Heights,2574,8,7,1
Maryland,Frederick,73042,192,146,46
Maryland,Frostburg,8451,21,17,4
Maryland,Fruitland,5362,23,20,3
Maryland,Glenarden,6177,18,16,2
Maryland,Greenbelt,23342,62,47,15
Maryland,Greensboro,1874,5,5,0
Maryland,Hagerstown,40136,108,91,17
Maryland,Hampstead,6410,10,9,1
Maryland,Havre de Grace,14132,42,31,11
Maryland,Hurlock,2015,11,10,1
Maryland,Hyattsville,18305,61,44,17
Maryland,Landover Hills,1642,6,5,1
Maryland,La Plata,9728,21,20,1
Maryland,Laurel,25704,82,64,18
Maryland,Luke,59,1,1,0
Maryland,Manchester,4855,7,6,1
Maryland,Morningside,1286,9,8,1
Maryland,Mount Airy,9476,10,8,2
Maryland,Mount Rainier,8126,19,14,5
Maryland,New Carrollton,12990,31,19,12
Maryland,North East,3648,11,10,1
Maryland,Oakland,1806,2,2,0
Maryland,Ocean City,6926,130,104,26
Maryland,Ocean Pines,11710,19,15,4
Maryland,Perryville,4428,12,11,1
Maryland,Pocomoke City,4078,24,17,7
Maryland,Princess Anne,3535,12,11,1
Maryland,Ridgely,1659,5,5,0
Maryland,Rising Sun,2780,5,5,0
Maryland,Riverdale Park,7229,30,23,7
Maryland,Rock Hall,1270,3,3,0
Maryland,Salisbury,33233,111,82,29
Maryland,Seat Pleasant,4761,29,24,5
Maryland,Smithsburg,2972,4,3,1
Maryland,Snow Hill,2043,7,7,0
Maryland,St. Michaels,1041,10,9,1
Maryland,Sykesville,3960,8,7,1
Maryland,Takoma Park,17831,61,40,21
Maryland,Taneytown,6824,16,14,2
Maryland,Thurmont,6977,15,12,3
Maryland,University Park,2639,8,7,1
Maryland,Upper Marlboro,675,4,3,1
Maryland,Westminster,18654,55,45,10
Massachusetts,Abington,17306,33,30,3
Massachusetts,Acton,23728,54,43,11
Massachusetts,Acushnet,10604,24,20,4
Massachusetts,Adams,7959,18,17,1
Massachusetts,Agawam,28533,66,53,13
Massachusetts,Amesbury,17578,39,33,6
Massachusetts,Amherst,40061,55,37,18
Massachusetts,Andover,36534,69,50,19
Massachusetts,Aquinnah,322,4,4,0
Massachusetts,Arlington,45582,82,68,14
Massachusetts,Ashburnham,6344,16,12,4
Massachusetts,Ashby,3217,8,7,1
Massachusetts,Ashfield,1715,2,2,0
Massachusetts,Ashland,17842,31,25,6
Massachusetts,Athol,11682,26,19,7
Massachusetts,Attleboro,45181,97,82,15
Massachusetts,Auburn,16736,50,38,12
Massachusetts,Avon,4561,20,15,5
Massachusetts,Ayer,8237,30,20,10
Massachusetts,Barnstable,44169,138,111,27
Massachusetts,Barre,5568,10,9,1
Massachusetts,Becket,1709,4,4,0
Massachusetts,Bedford,14135,35,28,7
Massachusetts,Belchertown,15148,26,20,6
Massachusetts,Bellingham,17331,34,26,8
Massachusetts,Belmont,26136,60,47,13
Massachusetts,Berkley,6864,13,13,0
Massachusetts,Berlin,3266,11,10,1
Massachusetts,Bernardston,2086,3,3,0
Massachusetts,Beverly,42229,73,69,4
Massachusetts,Billerica,43473,81,63,18
Massachusetts,Blackstone,9269,22,18,4
Massachusetts,Bolton,5455,13,12,1
Massachusetts,Boston,697323,2715,2132,583
Massachusetts,Bourne,19657,51,43,8
Massachusetts,Boxborough,5856,19,13,6
Massachusetts,Boxford,8328,9,9,0
Massachusetts,Boylston,4728,14,10,4
Massachusetts,Braintree,37278,98,82,16
Massachusetts,Brewster,9714,29,24,5
Massachusetts,Bridgewater,8107,45,43,2
Massachusetts,Brockton,99171,211,187,24
Massachusetts,Brookfield,3442,5,5,0
Massachusetts,Brookline,59057,187,137,50
Massachusetts,Buckland,1845,2,2,0
Massachusetts,Burlington,28960,68,61,7
Massachusetts,Cambridge,119938,312,271,41
Massachusetts,Canton,24015,45,45,0
Massachusetts,Carlisle,5267,15,10,5
Massachusetts,Carver,12197,22,17,5
Massachusetts,Charlton,13720,24,18,6
Massachusetts,Chatham,5935,27,21,6
Massachusetts,Chelmsford,35369,62,57,5
Massachusetts,Chelsea,39995,115,107,8
Massachusetts,Cheshire,3118,1,1,0
Massachusetts,Chicopee,54918,125,121,4
Massachusetts,Clinton,13967,36,26,10
Massachusetts,Cohasset,8653,20,19,1
Massachusetts,Concord,18952,42,33,9
Massachusetts,Dalton,6500,9,8,1
Massachusetts,Danvers,27517,57,45,12
Massachusetts,Dartmouth,33986,86,71,15
Massachusetts,Dedham,25217,58,54,4
Massachusetts,Deerfield,4976,10,9,1
Massachusetts,Dennis,13760,51,44,7
Massachusetts,Dighton,8026,15,14,1
Massachusetts,Douglas,9054,18,14,4
Massachusetts,Dover,6176,17,16,1
Massachusetts,Dracut,31708,44,41,3
Massachusetts,Dudley,11745,16,15,1
Massachusetts,Dunstable,3410,9,8,1
Massachusetts,Duxbury,16561,33,31,2
Massachusetts,East Bridgewater,15103,31,22,9
Massachusetts,East Brookfield,2200,4,4,0
Massachusetts,Eastham,4874,23,17,6
Massachusetts,Easthampton,15804,35,29,6
Massachusetts,East Longmeadow,16181,28,25,3
Massachusetts,Easton,25176,46,36,10
Massachusetts,Edgartown,4374,20,19,1
Massachusetts,Essex,3812,11,10,1
Massachusetts,Everett,46765,125,117,8
Massachusetts,Fairhaven,16014,37,31,6
Massachusetts,Fall River,89136,272,221,51
Massachusetts,Falmouth,30769,60,56,4
Massachusetts,Fitchburg,40443,92,77,15
Massachusetts,Foxborough,18539,41,39,2
Massachusetts,Framingham,74680,147,129,18
Massachusetts,Franklin,34281,55,53,2
Massachusetts,Freetown,9401,19,19,0
Massachusetts,Gardner,20629,51,32,19
Massachusetts,Georgetown,8783,18,13,5
Massachusetts,Gill,1464,2,2,0
Massachusetts,Gloucester,30445,67,60,7
Massachusetts,Goshen,1059,2,2,0
Massachusetts,Grafton,18908,24,20,4
Massachusetts,Granby,6297,15,11,4
Massachusetts,Great Barrington,6928,18,17,1
Massachusetts,Greenfield,17239,47,34,13
Massachusetts,Groton,11337,26,19,7
Massachusetts,Groveland,6856,13,11,2
Massachusetts,Hadley,5352,22,16,6
Massachusetts,Halifax,8207,11,10,1
Massachusetts,Hamilton,8038,18,13,5
Massachusetts,Hanson,11367,24,23,1
Massachusetts,Hardwick,3047,5,5,0
Massachusetts,Harwich,12068,34,28,6
Massachusetts,Haverhill,64015,117,100,17
Massachusetts,Hingham,25816,49,47,2
Massachusetts,Hinsdale,1899,5,4,1
Massachusetts,Holbrook,11035,23,22,1
Massachusetts,Holden,19412,39,24,15
Massachusetts,Holland,2473,2,2,0
Massachusetts,Holliston,14986,30,25,5
Massachusetts,Holyoke,40002,128,113,15
Massachusetts,Hopedale,5924,17,13,4
Massachusetts,Hopkinton,18806,36,26,10
Massachusetts,Hudson,19839,44,33,11
Massachusetts,Hull,10850,27,24,3
Massachusetts,Ipswich,14097,29,25,4
Massachusetts,Kingston,14481,32,24,8
Massachusetts,Lakeville,12053,24,19,5
Massachusetts,Lancaster,8040,12,11,1
Massachusetts,Lanesboro,2924,6,6,0
Massachusetts,Lawrence,79997,181,158,23
Massachusetts,Leicester,11329,21,20,1
Massachusetts,Lenox,4930,10,10,0
Massachusetts,Leominster,41598,92,76,16
Massachusetts,Leverett,1836,3,3,0
Massachusetts,Lexington,33138,61,45,16
Massachusetts,Lincoln,7092,18,13,5
Massachusetts,Littleton,10326,28,20,8
Massachusetts,Longmeadow,15640,27,25,2
Massachusetts,Lowell,110876,310,232,78
Massachusetts,Ludlow,21171,52,40,12
Massachusetts,Lunenburg,11874,17,16,1
Massachusetts,Lynn,94223,195,177,18
Massachusetts,Lynnfield,13093,27,21,6
Massachusetts,Malden,60231,110,101,9
Massachusetts,Mansfield,24484,46,37,9
Massachusetts,Marblehead,20525,39,30,9
Massachusetts,Marion,5396,15,15,0
Massachusetts,Marlborough,39498,81,67,14
Massachusetts,Mashpee,14180,44,35,9
Massachusetts,Mattapoisett,6659,20,20,0
Massachusetts,Maynard,11420,27,21,6
Massachusetts,Medfield,13034,25,19,6
Massachusetts,Medway,13534,26,25,1
Massachusetts,Melrose,27975,44,43,1
Massachusetts,Mendon,6232,17,14,3
Massachusetts,Methuen,50810,101,84,17
Massachusetts,Middleboro,26606,48,44,4
Massachusetts,Middleton,10189,17,16,1
Massachusetts,Millbury,13949,59,49,10
Massachusetts,Millis,8339,23,18,5
Massachusetts,Millville,3247,6,5,1
Massachusetts,Milton,27600,60,52,8
Massachusetts,Montague,8185,22,17,5
Massachusetts,Nahant,3505,13,12,1
Massachusetts,Nantucket,11484,56,38,18
Massachusetts,Natick,36200,70,54,16
Massachusetts,Needham,31586,59,50,9
Massachusetts,New Bedford,94886,291,248,43
Massachusetts,Newburyport,18288,37,32,5
Massachusetts,Newton,88281,194,149,45
Massachusetts,Norfolk,12068,23,21,2
Massachusetts,North Adams,12620,36,24,12
Massachusetts,Northampton,28428,66,59,7
Massachusetts,North Andover,31341,52,38,14
Massachusetts,North Attleboro,29280,62,45,17
Massachusetts,Northborough,15105,28,20,8
Massachusetts,Northbridge,16699,26,18,8
Massachusetts,Northfield,2950,3,3,0
Massachusetts,North Reading,15886,35,32,3
Massachusetts,Norton,19932,35,34,1
Massachusetts,Norwell,11605,26,23,3
Massachusetts,Norwood,29791,72,61,11
Massachusetts,Oak Bluffs,4677,19,17,2
Massachusetts,Oakham,1953,1,1,0
Massachusetts,Orleans,5745,28,22,6
Massachusetts,Oxford,13967,29,22,7
Massachusetts,Palmer,12200,29,22,7
Massachusetts,Paxton,4953,17,16,1
Massachusetts,Peabody,52975,102,85,17
Massachusetts,Pelham,1312,2,2,0
Massachusetts,Pembroke,19211,32,31,1
Massachusetts,Pepperell,12114,17,16,1
Massachusetts,Petersham,1244,2,2,0
Massachusetts,Pittsfield,41865,107,86,21
Massachusetts,Plymouth,64199,144,128,16
Massachusetts,Plympton,3105,9,8,1
Massachusetts,Princeton,3477,7,6,1
Massachusetts,Provincetown,2947,24,18,6
Massachusetts,Quincy,94519,258,224,34
Massachusetts,Randolph,32052,64,59,5
Massachusetts,Raynham,14512,38,30,8
Massachusetts,Reading,25417,59,44,15
Massachusetts,Rehoboth,12406,32,26,6
Massachusetts,Revere,52930,106,100,6
Massachusetts,Rockland,18652,34,31,3
Massachusetts,Rockport,7279,17,16,1
Massachusetts,Rowley,6509,17,12,5
Massachusetts,Salem,43154,103,92,11
Massachusetts,Salisbury,9630,26,15,11
Massachusetts,Sandwich,20008,44,34,10
Massachusetts,Saugus,28397,82,67,15
Massachusetts,Scituate,19655,34,33,1
Massachusetts,Seekonk,15927,40,38,2
Massachusetts,Sharon,19011,34,30,4
Massachusetts,Sheffield,3115,5,5,0
Massachusetts,Shelburne,1830,3,3,0
Massachusetts,Sherborn,4335,15,14,1
Massachusetts,Shirley,7632,13,11,2
Massachusetts,Shrewsbury,38656,59,45,14
Massachusetts,Somerset,18024,38,33,5
Massachusetts,Somerville,81552,155,122,33
Massachusetts,Southampton,6213,13,9,4
Massachusetts,Southborough,10202,25,20,5
Massachusetts,Southbridge,16805,49,38,11
Massachusetts,South Hadley,17613,33,28,5
Massachusetts,Southwick,9732,24,18,6
Massachusetts,Spencer,11896,23,18,5
Massachusetts,Springfield,153084,622,474,148
Massachusetts,Stockbridge,1884,7,6,1
Massachusetts,Stoneham,24329,45,37,8
Massachusetts,Stoughton,29067,69,58,11
Massachusetts,Stow,7266,12,10,2
Massachusetts,Sturbridge,9585,27,20,7
Massachusetts,Sudbury,19778,41,30,11
Massachusetts,Sunderland,3622,6,5,1
Massachusetts,Sutton,9600,19,15,4
Massachusetts,Swampscott,15391,29,28,1
Massachusetts,Swansea,16854,39,34,5
Massachusetts,Templeton,8110,14,9,5
Massachusetts,Tewksbury,31237,71,62,9
Massachusetts,Tisbury,4108,15,13,2
Massachusetts,Topsfield,6668,12,11,1
Massachusetts,Townsend,9515,14,13,1
Massachusetts,Truro,1997,17,12,5
Massachusetts,Uxbridge,14202,26,19,7
Massachusetts,Wakefield,27114,48,47,1
Massachusetts,Walpole,25273,55,44,11
Massachusetts,Waltham,62339,212,148,64
Massachusetts,Wareham,23619,52,43,9
Massachusetts,Warren,5203,7,6,1
Massachusetts,Watertown,36201,79,67,12
Massachusetts,Webster,16876,32,30,2
Massachusetts,Wellesley,28687,57,42,15
Massachusetts,Wellfleet,2707,20,15,5
Massachusetts,Wenham,5296,11,10,1
Massachusetts,Westborough,19138,37,35,2
Massachusetts,West Brookfield,3715,6,6,0
Massachusetts,Westfield,41072,84,80,4
Massachusetts,Westford,25011,52,48,4
Massachusetts,Westminster,8038,18,14,4
Massachusetts,Weston,12146,36,26,10
Massachusetts,Westport,16003,32,29,3
Massachusetts,West Tisbury,2919,10,9,1
Massachusetts,Westwood,16578,37,29,8
Massachusetts,Weymouth,58090,117,98,19
Massachusetts,Wilbraham,14690,28,27,1
Massachusetts,Williamsburg,2464,1,1,0
Massachusetts,Williamstown,7397,14,12,2
Massachusetts,Wilmington,23437,54,50,4
Massachusetts,Winchendon,10908,21,15,6
Massachusetts,Winchester,22827,49,40,9
Massachusetts,Winthrop,18561,31,30,1
Massachusetts,Woburn,40142,84,79,5
Massachusetts,Worcester,184850,492,442,50
Massachusetts,Wrentham,12112,23,22,1
Massachusetts,Yarmouth,23015,75,61,14
Michigan,Adrian,20540,32,30,2
Michigan,Adrian Township,6237,2,2,0
Michigan,Akron,372,1,1,0
Michigan,Albion,8381,20,19,1
Michigan,Allegan,5023,9,8,1
Michigan,Allen Park,26809,42,38,4
Michigan,Alma,8839,17,14,3
Michigan,Almont,2809,7,7,0
Michigan,Alpena,9900,18,16,2
Michigan,Ann Arbor,120647,145,118,27
Michigan,Argentine Township,6473,5,5,0
Michigan,Armada,1714,2,2,0
Michigan,Auburn Hills,25149,55,50,5
Michigan,Augusta,900,9,6,3
Michigan,Bad Axe,2893,7,7,0
Michigan,Bangor,1827,6,6,0
Michigan,Baraga,1935,2,2,0
Michigan,Baroda-Lake Township,3890,6,5,1
Michigan,Barryton,353,1,1,0
Michigan,Barry Township,3531,4,4,0
Michigan,Bath Township,13167,13,12,1
Michigan,Battle Creek,60479,123,103,20
Michigan,Bay City,32485,58,52,6
Michigan,Beaverton,1177,4,4,0
Michigan,Belding,5741,7,7,0
Michigan,Bellaire,1064,2,2,0
Michigan,Belleville,3887,8,7,1
Michigan,Bellevue,1305,2,2,0
Michigan,Benton Harbor,9710,30,29,1
Michigan,Benton Township,14251,27,21,6
Michigan,Berkley,15410,37,29,8
Michigan,Berrien Springs-Oronoko Township,8894,9,8,1
Michigan,Beverly Hills,10363,27,23,4
Michigan,Big Rapids,10355,20,18,2
Michigan,Birch Run,1468,6,5,1
Michigan,Birmingham,21536,44,33,11
Michigan,Blackman Township,37034,41,40,1
Michigan,Blissfield,3259,7,6,1
Michigan,Bloomfield Hills,4012,25,22,3
Michigan,Bloomfield Township,42059,81,65,16
Michigan,Boyne City,3729,7,6,1
Michigan,Breckenridge,1267,1,1,0
Michigan,Bridgeport Township,9736,9,8,1
Michigan,Bridgman,2204,5,5,0
Michigan,Brighton,7679,18,16,2
Michigan,Bronson,2298,4,4,0
Michigan,Brown City,1242,1,1,0
Michigan,Brownstown Township,32255,37,30,7
Michigan,Buchanan,4242,9,8,1
Michigan,Buena Vista Township,8047,13,12,1
Michigan,Burton,28427,38,36,2
Michigan,Cadillac,10513,17,16,1
Michigan,Cambridge Township,5679,4,4,0
Michigan,Canton Township,94128,102,93,9
Michigan,Capac,1832,2,2,0
Michigan,Carleton,2354,4,3,1
Michigan,Caro,3959,7,7,0
Michigan,Carrollton Township,5599,6,6,0
Michigan,Carson City,1111,1,1,0
Michigan,Caseville,730,2,2,0
Michigan,Caspian-Gaastra,1162,1,1,0
Michigan,Cass City,2260,4,4,0
Michigan,Cassopolis,1692,5,5,0
Michigan,Center Line,8162,25,20,5
Michigan,Central Lake,938,1,1,0
Michigan,Charlevoix,2486,8,7,1
Michigan,Charlotte,9091,16,15,1
Michigan,Cheboygan,4668,9,9,0
Michigan,Chelsea,5471,14,10,4
Michigan,Chesaning,2221,2,1,1
Michigan,Chesterfield Township,47059,59,45,14
Michigan,Chikaming Township,3078,7,6,1
Michigan,Chocolay Township,5918,5,4,1
Michigan,Clare,3071,7,7,0
Michigan,Clawson,11846,19,18,1
Michigan,Clayton Township,7057,7,6,1
Michigan,Clay Township,8886,23,18,5
Michigan,Clinton,2285,4,4,0
Michigan,Clinton Township,100884,103,94,9
Michigan,Clio,2482,4,4,0
Michigan,Coldwater,12076,20,18,2
Michigan,Coleman,1199,2,2,0
Michigan,Coloma Township,6319,10,7,3
Michigan,Colon,1155,3,3,0
Michigan,Columbia Township,7350,7,7,0
Michigan,Constantine,2110,6,5,1
Michigan,Corunna,3327,3,3,0
Michigan,Covert Township,2891,9,9,0
Michigan,Croswell,2269,5,5,0
Michigan,Crystal Falls,1354,1,1,0
Michigan,Davison,4848,6,5,1
Michigan,Davison Township,19197,22,20,2
Michigan,Dearborn,93507,230,186,44
Michigan,Dearborn Heights,55105,105,81,24
Michigan,Decatur,1724,5,5,0
Michigan,Denton Township,5421,4,4,0
Michigan,Detroit,659616,3149,2528,621
Michigan,DeWitt,4844,7,6,1
Michigan,DeWitt Township,15756,16,15,1
Michigan,Dowagiac,5648,14,13,1
Michigan,Dryden Township,4724,4,4,0
Michigan,Dundee,4681,5,5,0
Michigan,Durand,3818,5,5,0
Michigan,East Grand Rapids,12105,30,28,2
Michigan,East Jordan,2348,5,5,0
Michigan,East Lansing,48098,60,51,9
Michigan,Eastpointe,32046,47,42,5
Michigan,Eaton Rapids,5248,10,9,1
Michigan,Eau Claire,594,1,1,0
Michigan,Ecorse,9576,19,19,0
Michigan,Elk Rapids,1613,5,5,0
Michigan,Elkton,743,1,1,0
Michigan,Emmett Township,11611,16,14,2
Michigan,Erie Township,4308,4,3,1
Michigan,Escanaba,12111,44,32,12
Michigan,Essexville,3257,8,8,0
Michigan,Evart,1879,3,3,0
Michigan,Fair Haven Township,1038,1,1,0
Michigan,Farmington,10503,24,23,1
Michigan,Farmington Hills,80708,135,99,36
Michigan,Fennville,1433,5,5,0
Michigan,Fenton,11369,18,15,3
Michigan,Ferndale,20048,49,39,10
Michigan,Flat Rock,10019,20,18,2
Michigan,Flint,94842,117,95,22
Michigan,Flint Township,30178,48,41,7
Michigan,Flushing,7827,10,10,0
Michigan,Flushing Township,10133,9,8,1
Michigan,Forsyth Township,6182,10,8,2
Michigan,Fowlerville,2895,6,5,1
Michigan,Frankenmuth,5595,9,7,2
Michigan,Frankfort,1291,3,3,0
Michigan,Franklin,3256,11,11,0
Michigan,Fraser,14480,30,29,1
Michigan,Fremont,4077,9,8,1
Michigan,Fruitport Township,14476,10,10,0
Michigan,Gagetown,360,1,1,0
Michigan,Gaines Township,6103,1,1,0
Michigan,Galien,527,2,1,1
Michigan,Garden City,26282,38,35,3
Michigan,Garfield Township,850,1,1,0
Michigan,Gaylord,3692,12,11,1
Michigan,Genesee Township,20325,21,18,3
Michigan,Gerrish Township,2946,6,6,0
Michigan,Gibraltar,4505,10,9,1
Michigan,Gladstone,4670,11,10,1
Michigan,Gladwin,2887,5,5,0
Michigan,Grand Beach/Michiana,463,5,5,0
Michigan,Grand Blanc,7831,18,16,2
Michigan,Grand Blanc Township,36498,48,41,7
Michigan,Grand Haven,11126,33,30,3
Michigan,Grand Ledge,7908,16,16,0
Michigan,Grand Rapids,202513,360,291,69
Michigan,Grandville,15913,27,25,2
Michigan,Grant,883,2,2,0
Michigan,Grayling,1848,6,5,1
Michigan,Green Oak Township,19154,19,17,2
Michigan,Greenville,8415,17,15,2
Michigan,Grosse Ile Township,10114,23,17,6
Michigan,Grosse Pointe,5127,21,21,0
Michigan,Grosse Pointe Farms,9077,37,32,5
Michigan,Grosse Pointe Park,10998,38,33,5
Michigan,Grosse Pointe Shores,2786,18,18,0
Michigan,Grosse Pointe Woods,15269,37,31,6
Michigan,Hamburg Township,21867,19,18,1
Michigan,Hampton Township,9354,10,10,0
Michigan,Hamtramck,21514,38,33,5
Michigan,Hancock,4487,10,10,0
Michigan,Harbor Beach,1575,4,4,0
Michigan,Harbor Springs,1207,7,6,1
Michigan,Harper Woods,13679,31,27,4
Michigan,Hart,2064,5,5,0
Michigan,Hartford,2582,5,5,0
Michigan,Hastings,7307,17,15,2
Michigan,Hazel Park,16340,43,37,6
Michigan,Hesperia,927,3,3,0
Michigan,Highland Park,10680,12,11,1
Michigan,Hillsdale,7972,14,12,2
Michigan,Holland,33228,67,58,9
Michigan,Holly,6157,10,10,0
Michigan,Home Township,1370,1,1,0
Michigan,Houghton,7760,14,13,1
Michigan,Howell,9620,20,18,2
Michigan,Hudson,2200,3,3,0
Michigan,Huntington Woods,6268,17,16,1
Michigan,Huron Township,16288,29,22,7
Michigan,Imlay City,3567,10,9,1
Michigan,Inkster,24173,39,29,10
Michigan,Ionia,11153,17,15,2
Michigan,Iron Mountain,7274,15,14,1
Michigan,Iron River,2807,4,4,0
Michigan,Ironwood,4816,11,11,0
Michigan,Ishpeming,6410,12,11,1
Michigan,Ishpeming Township,3513,1,1,0
Michigan,Jackson,32332,52,43,9
Michigan,Jonesville,2210,3,3,0
Michigan,Kalamazoo,76411,258,235,23
Michigan,Kalamazoo Township,24562,36,32,4
Michigan,Kalkaska,2103,5,5,0
Michigan,Keego Harbor,3431,5,5,0
Michigan,Kentwood,52263,90,70,20
Michigan,Kingsford,4931,19,19,0
Michigan,Kingston,406,1,1,0
Michigan,Kinross Township,7439,2,2,0
Michigan,Laingsburg,1285,1,1,0
Michigan,Lake Angelus,308,1,1,0
Michigan,Lake Linden,942,1,1,0
Michigan,Lake Odessa,2043,4,4,0
Michigan,Lake Orion,3206,4,4,0
Michigan,Lakeview,1002,3,3,0
Michigan,L'Anse,1824,4,4,0
Michigan,Lansing,118651,250,199,51
Michigan,Lansing Township,8254,16,15,1
Michigan,Lapeer,8505,22,19,3
Michigan,Lathrup Village,4090,11,10,1
Michigan,Laurium,1889,4,4,0
Michigan,Lawton,1800,4,4,0
Michigan,Leslie,1903,4,4,0
Michigan,Lexington,1114,3,3,0
Michigan,Lincoln Park,36140,53,46,7
Michigan,Lincoln Township,14587,13,12,1
Michigan,Linden,3934,5,5,0
Michigan,Litchfield,1327,2,2,0
Michigan,Livonia,93342,157,118,39
Michigan,Lowell,4216,6,5,1
Michigan,Ludington,8111,16,14,2
Michigan,Luna Pier,1392,1,1,0
Michigan,Mackinac Island,469,8,8,0
Michigan,Mackinaw City,794,6,6,0
Michigan,Madison Heights,29906,62,48,14
Michigan,Madison Township,8229,5,5,0
Michigan,Mancelona,1364,1,1,0
Michigan,Manistee,6103,12,12,0
Michigan,Manistique,2923,8,8,0
Michigan,Manton,1588,1,1,0
Michigan,Marine City,4038,5,4,1
Michigan,Marlette,1755,4,4,0
Michigan,Marquette,20957,38,33,5
Michigan,Marshall,6954,15,15,0
Michigan,Marysville,9643,16,14,2
Michigan,Mason,8480,13,12,1
Michigan,Mattawan,1981,6,6,0
Michigan,Mayville,878,3,3,0
Michigan,Melvindale,10199,23,23,0
Michigan,Memphis,1174,1,1,0
Michigan,Mendon,848,1,1,0
Michigan,Menominee,7971,16,15,1
Michigan,Meridian Township,43598,37,34,3
Michigan,Metamora Township,4283,5,5,0
Michigan,Metro Police Authority of Genesee County,19883,29,26,3
Michigan,Midland,41682,52,50,2
Michigan,Milan,6065,17,12,5
Michigan,Milford,17038,21,19,2
Michigan,Millington,989,2,2,0
Michigan,Monroe,19433,42,36,6
Michigan,Montague,2361,4,4,0
Michigan,Montrose Township,7431,9,8,1
Michigan,Morenci,2139,7,7,0
Michigan,Morrice,908,2,2,0
Michigan,Mount Morris,2822,5,5,0
Michigan,Mount Morris Township,20207,29,25,4
Michigan,Mount Pleasant,24668,34,28,6
Michigan,Munising,2188,4,4,0
Michigan,Muskegon,36391,83,74,9
Michigan,Muskegon Heights,10724,25,22,3
Michigan,Muskegon Township,18022,15,14,1
Michigan,Napoleon Township,6767,5,5,0
Michigan,Nashville,1691,1,1,0
Michigan,Negaunee,4520,9,9,0
Michigan,Newaygo,2076,7,7,0
Michigan,New Baltimore,12377,25,15,10
Michigan,New Buffalo,1866,7,7,0
Michigan,New Era,439,1,1,0
Michigan,Niles,11102,28,17,11
Michigan,Northfield Township,8720,11,10,1
Michigan,North Muskegon,3793,8,8,0
Michigan,Northville,5956,14,13,1
Michigan,Northville Township,29434,47,34,13
Michigan,Norton Shores,24742,35,33,2
Michigan,Norway,2736,6,6,0
Michigan,Novi,61554,93,70,23
Michigan,Oak Park,29432,61,48,13
Michigan,Olivet,1782,2,2,0
Michigan,Ontwa Township-Edwardsburg,6602,9,8,1
Michigan,Orchard Lake,2483,9,8,1
Michigan,Oscoda Township,6741,13,12,1
Michigan,Otsego,3997,6,5,1
Michigan,Ovid,1616,2,2,0
Michigan,Owosso,14363,17,17,0
Michigan,Oxford,3570,13,9,4
Michigan,Paw Paw,3351,9,8,1
Michigan,Pentwater,847,2,2,0
Michigan,Perry,2084,4,4,0
Michigan,Petoskey,5767,19,18,1
Michigan,Pigeon,1111,2,2,0
Michigan,Pinckney,2419,6,6,0
Michigan,Pittsfield Township,39400,40,39,1
Michigan,Plainwell,3774,9,8,1
Michigan,Pleasant Ridge,2423,5,5,0
Michigan,Plymouth,9159,17,16,1
Michigan,Plymouth Township,26988,43,28,15
Michigan,Portage,49798,78,59,19
Michigan,Port Austin,618,2,2,0
Michigan,Port Huron,28602,62,54,8
Michigan,Portland,3955,6,6,0
Michigan,Potterville,2765,2,2,0
Michigan,Prairieville Township,3534,2,2,0
Michigan,Quincy,1614,3,3,0
Michigan,Raisin Township,7784,4,4,0
Michigan,Reading,1040,2,2,0
Michigan,Redford Township,46510,67,59,8
Michigan,Reed City,2388,4,4,0
Michigan,Reese,1355,2,2,0
Michigan,"Richfield Township, Genesee County",8292,11,9,2
Michigan,"Richfield Township, Roscommon County",3653,4,4,0
Michigan,Richland,841,4,4,0
Michigan,"Richland Township, Saginaw County",3904,4,4,0
Michigan,Richmond,5856,13,10,3
Michigan,River Rouge,7369,27,19,8
Michigan,Riverview,11986,22,21,1
Michigan,Rochester,13362,30,22,8
Michigan,Rockford,6472,11,10,1
Michigan,Rockwood,3145,9,8,1
Michigan,Rogers City,2636,6,6,0
Michigan,Romeo,3607,10,7,3
Michigan,Romulus,23533,55,42,13
Michigan,Roosevelt Park,3793,5,5,0
Michigan,Roseville,46983,70,67,3
Michigan,Rothbury,448,1,1,0
Michigan,Royal Oak,59506,112,78,34
Michigan,Saginaw,47767,63,55,8
Michigan,Saginaw Township,38971,48,43,5
Michigan,Saline,9400,17,13,4
Michigan,Sandusky,2503,6,5,1
Michigan,Saugatuck-Douglas,2322,5,4,1
Michigan,Sault Ste. Marie,13340,25,23,2
Michigan,Schoolcraft,1554,3,3,0
Michigan,Scottville,1211,2,2,0
Michigan,Sebewaing,1618,2,2,0
Michigan,Shelby,2008,2,2,0
Michigan,Shelby Township,81416,101,76,25
Michigan,Shepherd,1484,2,2,0
Michigan,Somerset Township,4520,3,3,0
Michigan,Southfield,72794,149,124,25
Michigan,Southgate,28848,42,37,5
Michigan,South Haven,4341,23,18,5
Michigan,South Lyon,11877,17,16,1
Michigan,South Rockwood,1655,2,2,0
Michigan,Sparta,4429,5,5,0
Michigan,Spring Arbor Township,7838,2,2,0
Michigan,Springport Township,2156,2,2,0
Michigan,Stanton,1423,1,1,0
Michigan,St. Charles,1880,1,1,0
Michigan,St. Clair,5259,8,8,0
Michigan,St. Clair Shores,58898,88,84,4
Michigan,Sterling Heights,132745,171,150,21
Michigan,St. Ignace,2311,5,5,0
Michigan,St. Johns,7954,12,11,1
Michigan,St. Joseph,8313,24,22,2
Michigan,St. Joseph Township,9638,12,11,1
Michigan,St. Louis,7244,8,7,1
Michigan,Stockbridge,1253,2,2,0
Michigan,Sturgis,10831,24,19,5
Michigan,Sumpter Township,9348,18,16,2
Michigan,Sylvan Lake,1869,5,5,0
Michigan,Tawas,4492,5,4,1
Michigan,Taylor,60698,93,79,14
Michigan,Tecumseh,8392,15,14,1
Michigan,Thetford Township,6605,1,1,0
Michigan,Thomas Township,11411,9,8,1
Michigan,Three Oaks,1537,3,3,0
Michigan,Three Rivers,7604,17,15,2
Michigan,Tittabawassee Township,10009,7,6,1
Michigan,Traverse City,15855,33,30,3
Michigan,Trenton,18085,34,33,1
Michigan,Troy,84441,149,103,46
Michigan,Tuscarora Township,2904,9,8,1
Michigan,Ubly,779,1,1,0
Michigan,Unadilla Township,3468,3,3,0
Michigan,Union City,1561,5,5,0
Michigan,Utica,5149,19,15,4
Michigan,Van Buren Township,28355,56,40,16
Michigan,Vassar,2525,5,5,0
Michigan,Vernon,767,1,1,0
Michigan,Vicksburg,3554,6,6,0
Michigan,Walker,25020,41,37,4
Michigan,Walled Lake,7142,6,6,0
Michigan,Warren,133928,234,198,36
Michigan,Waterford Township,72735,79,61,18
Michigan,Watersmeet Township,1350,1,1,0
Michigan,Watervliet,1639,3,3,0
Michigan,Wayland,4241,7,6,1
Michigan,Wayne,16734,26,23,3
Michigan,West Bloomfield Township,65711,110,80,30
Michigan,West Branch,2042,5,5,0
Michigan,Westland,81244,95,77,18
Michigan,White Cloud,1385,2,2,0
Michigan,Whitehall,2846,8,8,0
Michigan,White Lake Township,31505,38,29,9
Michigan,White Pigeon,1526,4,4,0
Michigan,Williamston,3976,7,6,1
Michigan,Wixom,14110,23,20,3
Michigan,Wolverine Lake,4835,7,7,0
Michigan,Woodhaven,12427,31,29,2
Michigan,Wyandotte,24757,46,35,11
Michigan,Wyoming,76071,100,86,14
Michigan,Yale,1861,4,4,0
Michigan,Ypsilanti,20240,35,31,4
Michigan,Zeeland,5540,11,10,1
Michigan,Zilwaukee,1516,1,1,0
Minnesota,Aitkin,1969,7,6,1
Minnesota,Akeley,444,1,1,0
Minnesota,Albany,2787,4,3,1
Minnesota,Albert Lea,17599,29,26,3
Minnesota,Alexandria,13978,27,24,3
Minnesota,Annandale,3549,6,5,1
Minnesota,Anoka,17593,39,29,10
Minnesota,Appleton,1316,3,3,0
Minnesota,Apple Valley,55846,59,51,8
Minnesota,Arlington,2136,5,4,1
Minnesota,Atwater,1117,1,1,0
Minnesota,Audubon,520,1,1,0
Minnesota,Austin,25267,37,34,3
Minnesota,Avon,1613,4,3,1
Minnesota,Babbitt,1485,5,5,0
Minnesota,Bagley,1409,3,3,0
Minnesota,Barnesville,2606,5,5,0
Minnesota,Battle Lake,935,3,3,0
Minnesota,Baxter,8447,16,15,1
Minnesota,Bayport,3799,6,6,0
Minnesota,Becker,4997,8,7,1
Minnesota,Belgrade/Brooten,1535,3,3,0
Minnesota,Belle Plaine,7243,12,10,2
Minnesota,Bemidji,15567,37,34,3
Minnesota,Benson,3022,7,6,1
Minnesota,Big Lake,11355,16,13,3
Minnesota,Blackduck,839,2,2,0
Minnesota,Blaine,66588,81,66,15
Minnesota,Blooming Prairie,1930,3,3,0
Minnesota,Bloomington,85159,145,119,26
Minnesota,Blue Earth,3087,5,5,0
Minnesota,Bovey,782,2,2,0
Minnesota,Braham,1819,5,5,0
Minnesota,Brainerd,13417,27,22,5
Minnesota,Breckenridge,3148,8,8,0
Minnesota,Breezy Point,2424,7,6,1
Minnesota,Breitung Township,611,2,2,0
Minnesota,Brooklyn Center,30744,58,47,11
Minnesota,Brooklyn Park,80897,134,99,35
Minnesota,Brownton,716,1,1,0
Minnesota,Buffalo,16550,21,17,4
Minnesota,Buffalo Lake,680,2,2,0
Minnesota,Burnsville,61445,85,75,10
Minnesota,Caledonia,2741,6,5,1
Minnesota,Callaway,230,1,1,0
Minnesota,Cambridge,9302,15,14,1
Minnesota,Canby,1658,3,3,0
Minnesota,Cannon Falls,4046,8,6,2
Minnesota,Centennial Lakes,11704,18,16,2
Minnesota,Champlin,25517,31,26,5
Minnesota,Chaska,27353,32,26,6
Minnesota,Chatfield,2834,5,5,0
Minnesota,Chisholm,4835,12,11,1
Minnesota,Clara City,1267,2,2,0
Minnesota,Clearbrook,521,1,1,0
Minnesota,Cloquet,11995,23,21,2
Minnesota,Cold Spring/Richmond,5791,11,10,1
Minnesota,Coleraine,1972,2,2,0
Minnesota,Columbia Heights,21291,32,25,7
Minnesota,Coon Rapids,63162,74,63,11
Minnesota,Corcoran,6352,10,9,1
Minnesota,Cottage Grove,37940,47,41,6
Minnesota,Crookston,7749,17,15,2
Minnesota,Crosby,2316,9,8,1
Minnesota,Crosslake,2378,6,6,0
Minnesota,Crystal,22987,40,34,6
Minnesota,Danube,453,1,1,0
Minnesota,Dawson/Boyd,1540,3,3,0
Minnesota,Dayton,6958,10,8,2
Minnesota,Deephaven,3963,8,7,1
Minnesota,Deer River,929,4,4,0
Minnesota,Deerwood,532,3,3,0
Minnesota,Detroit Lakes,9352,19,17,2
Minnesota,Dilworth,4469,8,7,1
Minnesota,Duluth,85555,177,152,25
Minnesota,Dundas,1679,3,3,0
Minnesota,Eagan,66618,86,73,13
Minnesota,Eagle Lake,3172,3,3,0
Minnesota,East Grand Forks,8526,25,23,2
Minnesota,East Range,3558,8,8,0
Minnesota,Eden Prairie,65353,93,70,23
Minnesota,Eden Valley,1039,1,1,0
Minnesota,Edina,53422,77,56,21
Minnesota,Elko New Market,4855,5,5,0
Minnesota,Elk River,25467,42,33,9
Minnesota,Ely,3344,8,7,1
Minnesota,Emily,843,2,2,0
Minnesota,Eveleth,3553,11,10,1
Minnesota,Fairfax,1120,2,2,0
Minnesota,Fairmont,9964,20,18,2
Minnesota,Faribault,23958,43,35,8
Minnesota,Farmington,23318,28,25,3
Minnesota,Fergus Falls,13834,28,23,5
Minnesota,Floodwood,521,3,2,1
Minnesota,Foley,2678,4,4,0
Minnesota,Forest Lake,21230,28,25,3
Minnesota,Frazee,1395,3,3,0
Minnesota,Fridley,27892,51,43,8
Minnesota,Fulda,1197,2,2,0
Minnesota,Gaylord,2196,4,4,0
Minnesota,Gilbert,1779,7,6,1
Minnesota,Glencoe,5532,9,8,1
Minnesota,Glenwood,2617,6,5,1
Minnesota,Glyndon,1370,4,4,0
Minnesota,Golden Valley,22060,43,31,12
Minnesota,Goodhue,1177,2,2,0
Minnesota,Goodview,4119,5,4,1
Minnesota,Grand Rapids,11253,23,20,3
Minnesota,Granite Falls,2677,7,6,1
Minnesota,Hallock,914,1,1,0
Minnesota,Hastings,22959,34,30,4
Minnesota,Hawley,2213,5,5,0
Minnesota,Hector,1039,3,3,0
Minnesota,Henderson,934,2,2,0
Minnesota,Henning,809,2,2,0
Minnesota,Hermantown,9661,18,15,3
Minnesota,Hibbing,15802,29,26,3
Minnesota,Hill City,580,1,1,0
Minnesota,Hokah,543,1,1,0
Minnesota,Hopkins,18568,38,30,8
Minnesota,Houston,963,2,2,0
Minnesota,Howard Lake,2155,3,3,0
Minnesota,Hutchinson,13966,34,22,12
Minnesota,International Falls,5747,12,12,0
Minnesota,Inver Grove Heights,35861,45,40,5
Minnesota,Isanti,6219,11,10,1
Minnesota,Isle,801,4,4,0
Minnesota,Janesville,2251,4,4,0
Minnesota,Jordan,6514,12,10,2
Minnesota,Kasson,6549,9,8,1
Minnesota,Keewatin,1008,3,3,0
Minnesota,La Crescent,5016,9,8,1
Minnesota,Lake City,5129,11,10,1
Minnesota,Lake Crystal,2482,3,3,0
Minnesota,Lakefield,1605,3,3,0
Minnesota,Lake Park,794,2,2,0
Minnesota,Lakes Area,10000,15,13,2
Minnesota,Lake Shore,1064,2,2,0
Minnesota,Lakeville,68688,69,60,9
Minnesota,Le Center,2517,3,3,0
Minnesota,Lester Prairie,1724,3,3,0
Minnesota,Le Sueur,4058,8,7,1
Minnesota,Lewiston,1539,2,2,0
Minnesota,Lino Lakes,22337,28,25,3
Minnesota,Litchfield,6641,11,10,1
Minnesota,Little Falls,8682,17,15,2
Minnesota,Long Prairie,3284,6,6,0
Minnesota,Lonsdale,4269,8,7,1
Minnesota,Madelia,2247,4,4,0
Minnesota,Madison Lake,1192,1,1,0
Minnesota,Mankato,43276,64,56,8
Minnesota,Maple Grove,73939,79,66,13
Minnesota,Mapleton,2189,3,3,0
Minnesota,Maplewood,41096,60,55,5
Minnesota,Marshall,13466,25,22,3
Minnesota,Medina,6952,12,11,1
Minnesota,Melrose,3663,6,5,1
Minnesota,Menahga,1302,3,3,0
Minnesota,Mendota Heights,11373,21,20,1
Minnesota,Milaca,2927,7,6,1
Minnesota,Minneapolis,435116,974,833,141
Minnesota,Minneota,1352,1,1,0
Minnesota,Minnesota Lake,634,1,1,0
Minnesota,Minnetonka,54561,63,55,8
Minnesota,Minnetrista,10738,17,13,4
Minnesota,Montevideo,5009,12,11,1
Minnesota,Montgomery,3061,8,7,1
Minnesota,Moorhead,44132,67,53,14
Minnesota,Moose Lake,2815,5,5,0
Minnesota,Morgan,834,1,1,0
Minnesota,Morris,5339,10,8,2
Minnesota,Motley,658,2,2,0
Minnesota,Mounds View,13421,23,21,2
Minnesota,Mountain Lake,2029,4,4,0
Minnesota,Nashwauk,948,4,4,0
Minnesota,New Brighton,22843,35,29,6
Minnesota,New Hope,20970,39,29,10
Minnesota,New Prague,8374,12,10,2
Minnesota,New Richland,1179,2,2,0
Minnesota,New Ulm,13181,22,22,0
Minnesota,New York Mills,1226,3,3,0
Minnesota,Nisswa,2112,6,6,0
Minnesota,North Branch,10841,14,12,2
Minnesota,Northfield,20820,29,24,5
Minnesota,North Mankato,14008,16,15,1
Minnesota,North St. Paul,12591,19,17,2
Minnesota,Oakdale,27990,39,31,8
Minnesota,Oak Park Heights,5071,10,9,1
Minnesota,Olivia,2316,5,5,0
Minnesota,Onamia,862,3,3,0
Minnesota,Orono,20387,31,27,4
Minnesota,Ortonville,1767,4,4,0
Minnesota,Osakis,1745,3,3,0
Minnesota,Osseo,2775,8,7,1
Minnesota,Owatonna,25720,40,36,4
Minnesota,Parkers Prairie,996,2,2,0
Minnesota,Park Rapids,4280,12,11,1
Minnesota,Paynesville,2530,5,5,0
Minnesota,Pelican Rapids,2563,5,5,0
Minnesota,Pequot Lakes,2315,7,6,1
Minnesota,Perham,3724,7,6,1
Minnesota,Pierz,1362,2,2,0
Minnesota,Pike Bay,1706,1,1,0
Minnesota,Pine River,925,3,3,0
Minnesota,Plainview,3293,8,7,1
Minnesota,Plymouth,80843,96,79,17
Minnesota,Preston,1285,3,3,0
Minnesota,Princeton,4728,14,12,2
Minnesota,Prior Lake,27748,34,30,4
Minnesota,Proctor,3025,8,7,1
Minnesota,Ramsey,28205,30,27,3
Minnesota,Red Wing,16304,32,27,5
Minnesota,Redwood Falls,4930,14,12,2
Minnesota,Renville,1178,3,3,0
Minnesota,Rice,1404,2,2,0
Minnesota,Richfield,36493,55,46,9
Minnesota,Robbinsdale,14437,29,23,6
Minnesota,Rochester,120336,209,145,64
Minnesota,Rogers,13769,23,20,3
Minnesota,Roseau,2677,6,5,1
Minnesota,Rosemount,25597,28,25,3
Minnesota,Roseville,36675,58,49,9
Minnesota,Rushford,1692,3,3,0
Minnesota,Sartell,19262,23,20,3
Minnesota,Sauk Centre,4528,8,7,1
Minnesota,Sauk Rapids,14300,18,17,1
Minnesota,Savage,33020,45,35,10
Minnesota,Sebeka,661,2,2,0
Minnesota,Shakopee,42076,58,46,12
Minnesota,Sherburn,1082,4,4,0
Minnesota,Silver Bay,1750,5,5,0
Minnesota,Slayton,1956,5,4,1
Minnesota,Sleepy Eye,3331,7,7,0
Minnesota,South Lake Minnetonka,12867,19,16,3
Minnesota,South St. Paul,20053,35,30,5
Minnesota,Springfield,1989,5,5,0
Minnesota,Spring Grove,1258,3,3,0
Minnesota,Spring Lake Park,6978,14,11,3
Minnesota,St. Anthony,9095,23,20,3
Minnesota,Staples,2999,8,7,1
Minnesota,Starbuck,1267,4,4,0
Minnesota,St. Charles,3760,7,7,0
Minnesota,St. Cloud,68751,135,109,26
Minnesota,St. Francis,7997,15,12,3
Minnesota,Stillwater,19736,27,22,5
Minnesota,St. James,4380,9,8,1
Minnesota,St. Joseph,7448,11,10,1
Minnesota,St. Louis Park,49058,69,56,13
Minnesota,St. Paul,309859,763,621,142
Minnesota,St. Paul Park,5374,8,8,0
Minnesota,St. Peter,12041,20,14,6
Minnesota,Thief River Falls,8849,17,15,2
Minnesota,Tracy,2068,3,3,0
Minnesota,Trimont,695,1,1,0
Minnesota,Truman,1034,2,2,0
Minnesota,Twin Valley,748,2,2,0
Minnesota,Two Harbors,3506,9,8,1
Minnesota,Tyler,1062,2,2,0
Minnesota,Verndale,567,2,2,0
Minnesota,Virginia,8337,24,24,0
Minnesota,Wabasha,2468,9,8,1
Minnesota,Wadena,4108,10,9,1
Minnesota,Waite Park,7812,21,18,3
Minnesota,Walker,932,3,3,0
Minnesota,Walnut Grove,799,1,1,0
Minnesota,Warroad,1795,6,5,1
Minnesota,Waseca,8805,20,18,2
Minnesota,Waterville,1894,4,4,0
Minnesota,Wayzata,6602,16,14,2
Minnesota,Wells,2152,5,5,0
Minnesota,Westbrook,700,1,1,0
Minnesota,West Concord,766,1,1,0
Minnesota,West Hennepin,5995,12,10,2
Minnesota,West St. Paul,20007,35,31,4
Minnesota,Wheaton,1275,3,3,0
Minnesota,White Bear Lake,26036,35,31,4
Minnesota,Willmar,19901,39,35,4
Minnesota,Windom,4358,10,9,1
Minnesota,Winnebago,1330,3,3,0
Minnesota,Winona,26487,43,39,4
Minnesota,Winsted,2230,4,4,0
Minnesota,Winthrop,1340,3,3,0
Minnesota,Woodbury,74110,79,68,11
Minnesota,Worthington,13131,35,24,11
Minnesota,Wyoming,8095,10,9,1
Minnesota,Zumbrota,3526,6,6,0
Mississippi,Aberdeen,5163,19,14,5
Mississippi,Ackerman,1438,5,5,0
Mississippi,Amory,6740,28,21,7
Mississippi,Batesville,7193,53,41,12
Mississippi,Bay Springs,1645,8,7,1
Mississippi,Biloxi,46433,179,126,53
Mississippi,Booneville,8472,28,21,7
Mississippi,Brandon,24545,47,34,13
Mississippi,Brookhaven,11886,45,35,10
Mississippi,Bruce,1805,6,6,0
Mississippi,Byram,11418,41,28,13
Mississippi,Canton,12103,31,19,12
Mississippi,Carthage,4753,22,16,6
Mississippi,Charleston,1836,10,10,0
Mississippi,Clarksdale,14591,39,31,8
Mississippi,Cleveland,10944,55,46,9
Mississippi,Clinton,24349,75,56,19
Mississippi,Coldwater,1518,5,5,0
Mississippi,Collins,2409,28,20,8
Mississippi,Crenshaw,841,2,2,0
Mississippi,Decatur,1692,5,5,0
Mississippi,D'Iberville,14298,37,34,3
Mississippi,Drew,1576,1,1,0
Mississippi,Durant,2220,8,4,4
Mississippi,Edwards,1000,3,3,0
Mississippi,Ellisville,4573,10,8,2
Mississippi,Eupora,1985,8,7,1
Mississippi,Fayette,1420,7,5,2
Mississippi,Flora,1859,10,9,1
Mississippi,Florence,4536,19,16,3
Mississippi,Flowood,9564,62,48,14
Mississippi,Forest,5517,20,16,4
Mississippi,Fulton,3984,11,11,0
Mississippi,Gautier,18479,40,28,12
Mississippi,Gloster,860,7,4,3
Mississippi,Grenada,12131,38,32,6
Mississippi,Gulfport,72142,211,158,53
Mississippi,Hattiesburg,45870,166,103,63
Mississippi,Hazlehurst,3699,21,13,8
Mississippi,Hernando,16675,53,42,11
Mississippi,Hollandale,2264,12,6,6
Mississippi,Holly Springs,7799,22,18,4
Mississippi,Horn Lake,27404,60,43,17
Mississippi,Houston,3405,4,2,2
Mississippi,Indianola,8877,28,20,8
Mississippi,Inverness,851,3,3,0
Mississippi,Iuka,2926,12,9,3
Mississippi,Kosciusko,6652,21,21,0
Mississippi,Laurel,18317,65,46,19
Mississippi,Leland,3694,20,14,6
Mississippi,Lexington,1425,11,11,0
Mississippi,Long Beach,16161,46,31,15
Mississippi,Louisville,5917,21,20,1
Mississippi,Lucedale,3179,21,15,6
Mississippi,Madison,25831,92,71,21
Mississippi,Magee,4062,42,32,10
Mississippi,Mendenhall,2374,8,5,3
Mississippi,Meridian,35855,89,69,20
Mississippi,Morton,3509,11,11,0
Mississippi,Moss Point,13315,34,25,9
Mississippi,Natchez,14497,46,38,8
Mississippi,New Augusta,597,1,1,0
Mississippi,Newton,3133,16,14,2
Mississippi,Ocean Springs,17917,48,34,14
Mississippi,Okolona,2577,9,9,0
Mississippi,Olive Branch,39566,103,84,19
Mississippi,Oxford,28866,91,79,12
Mississippi,Pascagoula,21633,69,49,20
Mississippi,Pass Christian,6527,27,20,7
Mississippi,Pearl,26596,80,60,20
Mississippi,Petal,10652,30,26,4
Mississippi,Philadelphia,7036,32,23,9
Mississippi,Picayune,10826,39,26,13
Mississippi,Pickens,979,4,4,0
Mississippi,Poplarville,2901,8,8,0
Mississippi,Purvis,2416,14,11,3
Mississippi,Quitman,2089,8,8,0
Mississippi,Raymond,2142,11,10,1
Mississippi,Richland,7276,48,35,13
Mississippi,Ridgeland,24080,84,58,26
Mississippi,Rolling Fork,1908,11,10,1
Mississippi,Ruleville,2512,16,16,0
Mississippi,Sandersville,728,15,15,0
Mississippi,Shelby,1920,7,2,5
Mississippi,Southaven,56573,156,123,33
Mississippi,Starkville,25854,66,57,9
Mississippi,Stonewall,963,8,8,0
Mississippi,Summit,1555,7,6,1
Mississippi,Sunflower,960,2,2,0
Mississippi,Terry,1246,2,2,0
Mississippi,Tupelo,38383,124,110,14
Mississippi,Union,1888,8,7,1
Mississippi,Utica,890,2,2,0
Mississippi,Vicksburg,21420,63,49,14
Mississippi,Water Valley,3242,10,9,1
Mississippi,Waveland,6287,20,19,1
Mississippi,Waynesboro,4779,10,10,0
Mississippi,West Point,10314,34,30,4
Mississippi,Wiggins,4555,21,15,6
Mississippi,Winona,3861,8,8,0
Mississippi,Yazoo City,10806,19,14,5
Missouri,Adrian,1588,4,4,0
Missouri,Advance,1335,3,3,0
Missouri,Annapolis,341,1,1,0
Missouri,Arbyrd,457,1,1,0
Missouri,Arcadia,555,3,3,0
Missouri,Arnold,21115,62,54,8
Missouri,Ashland,3996,8,7,1
Missouri,Aurora,7441,24,17,7
Missouri,Auxvasse,977,6,6,0
Missouri,Ava,2852,12,7,5
Missouri,Ballwin,30044,56,45,11
Missouri,Bel-Nor,1391,8,8,0
Missouri,Belton,23698,61,39,22
Missouri,Berkeley,8809,34,27,7
Missouri,Birch Tree,646,1,1,0
Missouri,Bonne Terre,7135,10,10,0
Missouri,Boonville,8450,28,21,7
Missouri,Bourbon,1579,5,5,0
Missouri,Bowling Green,5617,12,10,2
Missouri,Branson,11745,68,48,20
Missouri,Branson West,443,14,14,0
Missouri,Breckenridge Hills,4548,18,16,2
Missouri,Brentwood,7957,29,28,1
Missouri,Bridgeton,11521,65,57,8
Missouri,Brookfield,4179,12,10,2
Missouri,Buckner,3016,8,7,1
Missouri,Buffalo,3092,8,7,1
Missouri,California,4429,8,7,1
Missouri,Calverton Park,1266,12,9,3
Missouri,Cameron,9618,24,16,8
Missouri,Campbell,1788,8,8,0
Missouri,Canalou,297,1,1,0
Missouri,Carl Junction,8366,16,11,5
Missouri,Caruthersville,5268,14,13,1
Missouri,Cassville,3293,10,10,0
Missouri,Centralia,4298,13,9,4
Missouri,Charleston,5422,18,12,6
Missouri,Chesterfield,47544,112,98,14
Missouri,Chillicothe,9735,27,18,9
Missouri,Clarkton,1138,2,2,0
Missouri,Clayton,16837,54,45,9
Missouri,Clever,2842,7,6,1
Missouri,Columbia,124829,195,158,37
Missouri,Country Club Hills,1244,7,7,0
Missouri,Country Club Village,2501,1,1,0
Missouri,Crestwood,11829,30,24,6
Missouri,Creve Coeur,18716,52,47,5
Missouri,Crocker,1030,3,3,0
Missouri,Crystal City,4685,22,16,6
Missouri,Cuba,3286,16,15,1
Missouri,Delta,423,1,1,0
Missouri,De Soto,6341,28,19,9
Missouri,Dexter,7807,26,18,8
Missouri,Diamond,912,2,2,0
Missouri,Doniphan,1907,10,6,4
Missouri,East Prairie,2922,9,4,5
Missouri,Edgar Springs,193,1,1,0
Missouri,Edmundson,828,11,10,1
Missouri,Eldon,4721,13,12,1
Missouri,El Dorado Springs,3617,12,8,4
Missouri,Ellisville,9927,25,24,1
Missouri,Ellsinore,427,2,2,0
Missouri,Excelsior Springs,11802,32,23,9
Missouri,Farmington,19446,32,30,2
Missouri,Fayette,2689,7,7,0
Missouri,Ferguson,20454,39,34,5
Missouri,Flordell Hills,799,8,8,0
Missouri,Florissant,50812,118,92,26
Missouri,Fordland,852,1,1,0
Missouri,Forsyth,2570,7,6,1
Missouri,Fredericktown,3984,15,14,1
Missouri,Frontenac,3839,22,21,1
Missouri,Fulton,12578,30,24,6
Missouri,Galena,437,1,1,0
Missouri,Gideon,960,2,2,0
Missouri,Grain Valley,14722,28,23,5
Missouri,Granby,2080,4,4,0
Missouri,Grandview,24898,66,52,14
Missouri,Hamilton,1671,5,5,0
Missouri,Hannibal,17299,45,34,11
Missouri,Hardin,533,1,1,0
Missouri,Harrisonville,10083,29,23,6
Missouri,Hartville,605,2,2,0
Missouri,Hayti,2458,5,5,0
Missouri,Hazelwood,25051,78,59,19
Missouri,Herculaneum,4216,9,8,1
Missouri,Hermann,2332,12,6,6
Missouri,Higginsville,4589,22,10,12
Missouri,Highlandville,1066,1,1,0
Missouri,Hillsdale,1549,12,11,1
Missouri,Holden,2234,7,7,0
Missouri,Holts Summit,5157,12,10,2
Missouri,Houston,2081,8,8,0
Missouri,Howardville,333,2,1,1
Missouri,Independence,116648,257,176,81
Missouri,Ironton,1381,8,8,0
Missouri,Jackson,14955,30,29,1
Missouri,Jasper,976,2,2,0
Missouri,Jefferson City,42653,124,88,36
Missouri,Kansas City,499335,1241,989,252
Missouri,Kearney,11164,17,16,1
Missouri,Kennett,10005,40,30,10
Missouri,Kirkwood,27834,88,60,28
Missouri,Knob Noster,2792,8,7,1
Missouri,Ladue,8627,34,29,5
Missouri,La Grange,888,5,5,0
Missouri,Lake Lafayette,337,1,1,0
Missouri,Lake Lotawana,2129,7,6,1
Missouri,Lake Ozark,1856,16,11,5
Missouri,Lakeshire,1384,10,10,0
Missouri,Lake St. Louis,17136,42,34,8
Missouri,Lake Tapawingo,718,4,3,1
Missouri,Lake Winnebago,1285,7,7,0
Missouri,La Plata,1302,4,4,0
Missouri,Laurie,969,4,4,0
Missouri,Leadington,622,1,1,0
Missouri,Lee's Summit,100268,192,140,52
Missouri,Lexington,4513,10,8,2
Missouri,Licking,3070,5,5,0
Missouri,Lincoln,1194,4,4,0
Missouri,Linn,1610,5,5,0
Missouri,Lone Jack,1357,9,8,1
Missouri,Louisiana,3191,6,5,1
Missouri,Malden,3851,15,13,2
Missouri,Manchester,18072,39,35,4
Missouri,Mansfield,1240,5,5,0
Missouri,Maplewood,8096,35,33,2
Missouri,Marble Hill,1461,5,4,1
Missouri,Marionville,2175,2,2,0
Missouri,Marshall,12817,31,24,7
Missouri,Marshfield,7667,12,11,1
Missouri,Maryland Heights,26901,112,77,35
Missouri,Memphis,1835,3,3,0
Missouri,Merriam Woods,1858,5,5,0
Missouri,Mexico,11517,29,28,1
Missouri,Milan,1755,4,4,0
Missouri,Miner,930,10,10,0
Missouri,Moline Acres,2338,18,17,1
Missouri,Monett,9150,23,21,2
Missouri,Morehouse,854,1,1,0
Missouri,Moscow Mills,3620,8,8,0
Missouri,Mound City,1026,2,2,0
Missouri,Mountain View,2641,8,7,1
Missouri,Mount Vernon,4502,11,11,0
Missouri,Neosho,12077,29,27,2
Missouri,New Franklin,1054,3,3,0
Missouri,New London,987,2,2,0
Missouri,Nixa,22924,39,33,6
Missouri,Normandy,7405,26,25,1
Missouri,Northwoods,4350,16,15,1
Missouri,Oakland,1366,88,60,28
Missouri,Odessa,5238,11,10,1
Missouri,Old Monroe,290,2,1,1
Missouri,Olivette,7829,23,22,1
Missouri,Oregon,756,1,1,0
Missouri,Oronogo,2700,4,4,0
Missouri,Orrick,800,2,2,0
Missouri,Osage Beach,4696,25,23,2
Missouri,Overland,15497,51,45,6
Missouri,Ozark,20788,39,36,3
Missouri,Palmyra,3597,9,8,1
Missouri,Peculiar,5582,9,8,1
Missouri,Perry,696,1,1,0
Missouri,Pevely,6020,21,15,6
Missouri,Piedmont,1879,6,6,0
Missouri,Pierce City,1311,2,2,0
Missouri,Pilot Grove,760,1,1,0
Missouri,Pineville,808,4,4,0
Missouri,Platte City,4987,12,12,0
Missouri,Platte Woods,407,4,4,0
Missouri,Pleasant Hill,8744,20,13,7
Missouri,Pleasant Valley,3042,27,14,13
Missouri,Poplar Bluff,16927,54,42,12
Missouri,Puxico,842,1,1,0
Missouri,Queen City,628,1,1,0
Missouri,Qulin,456,1,1,0
Missouri,Raymore,22545,39,26,13
Missouri,Raytown,28922,48,34,14
Missouri,Reeds Spring,863,3,3,0
Missouri,Republic,17174,25,21,4
Missouri,Rich Hill,1309,2,2,0
Missouri,Richland,1785,5,5,0
Missouri,Richmond,5638,12,10,2
Missouri,Richmond Heights,8831,37,36,1
Missouri,Riverside,3574,36,27,9
Missouri,Riverview,2820,13,12,1
Missouri,Rogersville,3960,10,10,0
Missouri,Rolla,20522,58,35,23
Missouri,Salem,4915,18,13,5
Missouri,Salisbury,1513,4,3,1
Missouri,Sarcoxie,1548,3,3,0
Missouri,Savannah,5240,6,5,1
Missouri,Scott City,4458,18,13,5
Missouri,Sedalia,21639,60,43,17
Missouri,Seligman,841,4,4,0
Missouri,Senath,1595,3,3,0
Missouri,Seneca,2392,6,6,0
Missouri,Seymour,2021,7,7,0
Missouri,Shrewsbury,6074,23,21,2
Missouri,Sikeston,15987,66,48,18
Missouri,Smithville,11097,20,19,1
Missouri,Southwest City,954,3,3,0
Missouri,Springfield,168856,404,329,75
Missouri,St. Ann,12586,67,46,21
Missouri,Steele,1861,4,4,0
Missouri,St. John,6318,23,22,1
Missouri,St. Joseph,74680,169,128,41
Missouri,St. Louis,298422,1659,1262,397
Missouri,Stover,1094,3,3,0
Missouri,Strasburg,142,2,2,0
Missouri,St. Robert,6485,27,19,8
Missouri,Sullivan,7128,26,19,7
Missouri,Summersville,489,3,3,0
Missouri,Sunset Hills,8445,32,25,7
Missouri,Thayer,2121,13,8,5
Missouri,Town and Country,11142,30,29,1
Missouri,Troy,13089,25,23,2
Missouri,Truesdale,905,1,1,0
Missouri,Union,12195,26,24,2
Missouri,University City,34045,91,70,21
Missouri,Van Buren,795,5,5,0
Missouri,Velda City,1355,7,4,3
Missouri,Verona,599,2,2,0
Missouri,Versailles,2477,17,16,1
Missouri,Viburnum,648,3,3,0
Missouri,Vienna,591,2,2,0
Missouri,Vinita Park,10951,42,40,2
Missouri,Walnut Grove,794,2,2,0
Missouri,Warrensburg,20591,31,26,5
Missouri,Warrenton,8450,27,23,4
Missouri,Warson Woods,1892,6,6,0
Missouri,Washington,14092,32,29,3
Missouri,Waynesville,5338,27,25,2
Missouri,Weatherby Lake,2115,15,15,0
Missouri,Webb City,12264,27,23,4
Missouri,Webster Groves,22798,48,46,2
Missouri,Wellington,804,3,3,0
Missouri,Wellsville,1153,3,3,0
Missouri,Weston,1834,4,4,0
Missouri,Willow Springs,2090,12,10,2
Missouri,Winona,1289,1,1,0
Missouri,Woodson Terrace,4032,20,18,2
Missouri,Wright City,4458,15,14,1
Montana,Baker,1907,4,4,0
Montana,Belgrade,9762,23,19,4
Montana,Billings,110157,184,156,28
Montana,Boulder,1287,3,3,0
Montana,Bozeman,51460,69,60,9
Montana,Bridger,760,3,3,0
Montana,Chinook,1260,4,4,0
Montana,Colstrip,2249,11,7,4
Montana,Columbia Falls,6023,11,10,1
Montana,Columbus,2100,4,4,0
Montana,Conrad,2458,5,5,0
Montana,Cut Bank,3075,9,7,2
Montana,Deer Lodge,2822,6,6,0
Montana,Dillon,4318,11,10,1
Montana,East Helena,2113,4,4,0
Montana,Ennis,1012,1,1,0
Montana,Eureka,1407,4,4,0
Montana,Fairview,867,3,3,0
Montana,Fort Benton,1429,4,4,0
Montana,Glasgow,3326,10,6,4
Montana,Glendive,4908,15,10,5
Montana,Great Falls,58345,127,87,40
Montana,Hamilton,4970,15,14,1
Montana,Havre,9820,26,20,6
Montana,Helena,33629,69,47,22
Montana,Hot Springs,587,2,2,0
Montana,Kalispell,25125,51,41,10
Montana,Laurel,6732,20,14,6
Montana,Lewistown,5772,24,13,11
Montana,Libby,2797,6,6,0
Montana,Livingston,7892,14,14,0
Montana,Manhattan,1955,4,4,0
Montana,Miles City,8250,17,16,1
Montana,Missoula,76468,144,116,28
Montana,Plains,1149,2,2,0
Montana,Polson,5115,16,15,1
Montana,Red Lodge,2324,7,7,0
Montana,Ronan City,2141,6,6,0
Montana,Sidney,6279,12,11,1
Montana,Stevensville,2100,4,3,1
Montana,Thompson Falls,1439,4,4,0
Montana,Troy,966,4,4,0
Montana,West Yellowstone,1388,11,5,6
Montana,Whitefish,8523,20,17,3
Montana,Wolf Point,2744,8,6,2
Nebraska,Albion,1576,6,3,3
Nebraska,Alliance,8051,23,15,8
Nebraska,Aurora,4554,11,10,1
Nebraska,Bayard,1071,4,4,0
Nebraska,Beatrice,12238,36,22,14
Nebraska,Bellevue,53761,106,93,13
Nebraska,Bennington,1527,3,3,0
Nebraska,Blair,7919,18,16,2
Nebraska,Boys Town,545,14,14,0
Nebraska,Broken Bow,3492,8,7,1
Nebraska,Burwell,1157,2,2,0
Nebraska,Central City,2867,7,6,1
Nebraska,Chadron,5366,18,11,7
Nebraska,Columbus,23597,43,36,7
Nebraska,Crete,7009,13,13,0
Nebraska,Emerson,787,1,1,0
Nebraska,Falls City,4094,13,9,4
Nebraska,Fremont,26381,41,35,6
Nebraska,Gering,8086,19,17,2
Nebraska,Gordon,1512,8,6,2
Nebraska,Gothenburg,3432,7,6,1
Nebraska,Grand Island,51547,101,84,17
Nebraska,Harvard,959,2,2,0
Nebraska,Hastings,24638,53,39,14
Nebraska,Holdrege,5399,17,10,7
Nebraska,Imperial,2053,4,4,0
Nebraska,Kearney,34201,73,57,16
Nebraska,Kimball,2359,4,4,0
Nebraska,Laurel,911,1,1,0
Nebraska,La Vista,17228,45,39,6
Nebraska,Lexington,10103,21,19,2
Nebraska,Lincoln,292600,481,342,139
Nebraska,Madison,2390,3,3,0
Nebraska,McCook,7543,23,16,7
Nebraska,Milford,2090,3,3,0
Nebraska,Minden,2954,6,6,0
Nebraska,Mitchell,1614,4,4,0
Nebraska,Morrill,885,2,2,0
Nebraska,Nebraska City,7292,15,14,1
Nebraska,Neligh,1488,3,3,0
Nebraska,Norfolk,24467,58,40,18
Nebraska,North Platte,23523,62,40,22
Nebraska,Ogallala,4472,10,9,1
Nebraska,Omaha,480297,1012,867,145
Nebraska,O'Neill,3565,8,7,1
Nebraska,Ord,2069,4,4,0
Nebraska,Papillion,20512,50,46,4
Nebraska,Pierce,1724,3,3,0
Nebraska,Plattsmouth,6435,17,14,3
Nebraska,Ralston,7422,15,14,1
Nebraska,Ravenna,1357,2,2,0
Nebraska,Schuyler,6312,11,9,2
Nebraska,Scottsbluff,15665,35,31,4
Nebraska,Scribner,793,1,1,0
Nebraska,Seward,7242,13,11,2
Nebraska,Sidney,6049,13,11,2
Nebraska,South Sioux City,12746,28,27,1
Nebraska,St. Paul,2336,4,4,0
Nebraska,Superior,1791,2,2,0
Nebraska,Sutton,1427,2,2,0
Nebraska,Tekamah,1696,5,5,0
Nebraska,Tilden,927,1,1,0
Nebraska,Valentine,2704,6,5,1
Nebraska,Valley,2948,5,5,0
Nebraska,Wahoo,4550,7,7,0
Nebraska,Waterloo,922,4,4,0
Nebraska,Wayne,5658,11,6,5
Nebraska,West Point,3273,7,5,2
Nebraska,Wymore,1324,2,2,0
Nebraska,York,7854,17,15,2
Nevada,Boulder City,16346,48,35,13
Nevada,Carlin,2268,7,5,2
Nevada,Elko,20697,45,38,7
Nevada,Fallon,8648,40,27,13
Nevada,Henderson,328056,654,463,191
Nevada,Las Vegas Metropolitan Police Department,1693061,5716,4115,1601
Nevada,Lovelock,1822,5,2,3
Nevada,Mesquite,20290,49,36,13
Nevada,Reno,259168,469,339,130
Nevada,Sparks,106664,159,108,51
Nevada,West Wendover,4258,21,12,9
Nevada,Winnemucca,7786,28,23,5
Nevada,Yerington,3256,7,6,1
New Hampshire,Alexandria,1618,1,1,0
New Hampshire,Allenstown,4462,11,10,1
New Hampshire,Alstead,1938,2,2,0
New Hampshire,Alton,5343,14,12,2
New Hampshire,Amherst,11414,20,19,1
New Hampshire,Antrim,2697,7,6,1
New Hampshire,Ashland,2053,5,5,0
New Hampshire,Atkinson,7196,9,8,1
New Hampshire,Auburn,5662,12,10,2
New Hampshire,Barnstead,4762,4,4,0
New Hampshire,Barrington,9358,14,13,1
New Hampshire,Bartlett,2807,4,4,0
New Hampshire,Bedford,22788,53,40,13
New Hampshire,Belmont,7342,17,14,3
New Hampshire,Bennington,1518,2,2,0
New Hampshire,Berlin,10140,31,23,8
New Hampshire,Bethlehem,2579,6,6,0
New Hampshire,Boscawen,4032,8,7,1
New Hampshire,Bow,8032,13,12,1
New Hampshire,Bradford,1714,3,3,0
New Hampshire,Brentwood,4525,4,3,1
New Hampshire,Bristol,3102,10,9,1
New Hampshire,Brookline,5506,9,8,1
New Hampshire,Campton,3297,9,7,2
New Hampshire,Canaan,3894,6,5,1
New Hampshire,Candia,3970,8,7,1
New Hampshire,Canterbury,2475,3,3,0
New Hampshire,Carroll,745,4,4,0
New Hampshire,Center Harbor,1099,5,4,1
New Hampshire,Charlestown,5010,11,7,4
New Hampshire,Chester,5334,9,8,1
New Hampshire,Chesterfield,3630,5,4,1
New Hampshire,Chichester,2726,5,5,0
New Hampshire,Claremont,12887,27,21,6
New Hampshire,Colebrook,2121,5,5,0
New Hampshire,Concord,43737,93,81,12
New Hampshire,Conway,10269,30,22,8
New Hampshire,Danville,4581,5,5,0
New Hampshire,Deerfield,4576,9,8,1
New Hampshire,Deering,1978,2,2,0
New Hampshire,Derry,33555,69,56,13
New Hampshire,Dover,32480,76,49,27
New Hampshire,Dublin,1538,4,3,1
New Hampshire,Dunbarton,2894,5,5,0
New Hampshire,Durham,16510,20,17,3
New Hampshire,East Kingston,2428,6,5,1
New Hampshire,Effingham,1479,1,1,0
New Hampshire,Enfield,4526,8,7,1
New Hampshire,Epping,7115,16,15,1
New Hampshire,Epsom,4787,7,6,1
New Hampshire,Exeter,15448,32,24,8
New Hampshire,Farmington,7003,15,14,1
New Hampshire,Fitzwilliam,2367,4,3,1
New Hampshire,Franconia,1105,4,4,0
New Hampshire,Franklin,8711,25,17,8
New Hampshire,Freedom,1593,2,2,0
New Hampshire,Fremont,4764,6,5,1
New Hampshire,Gilford,7258,26,20,6
New Hampshire,Gilmanton,3779,6,5,1
New Hampshire,Goffstown,18098,45,30,15
New Hampshire,Gorham,2587,10,6,4
New Hampshire,Grantham,2942,6,5,1
New Hampshire,Greenland,4194,10,9,1
New Hampshire,Hampstead,8654,9,9,0
New Hampshire,Hampton,15570,42,35,7
New Hampshire,Hampton Falls,2437,4,4,0
New Hampshire,Hancock,1657,3,3,0
New Hampshire,Hanover,11498,28,17,11
New Hampshire,Haverhill,4551,7,6,1
New Hampshire,Henniker,5039,9,8,1
New Hampshire,Hillsborough,6001,23,15,8
New Hampshire,Hinsdale,3893,9,6,3
New Hampshire,Holderness,2106,7,6,1
New Hampshire,Hollis,8040,18,15,3
New Hampshire,Hooksett,14668,40,29,11
New Hampshire,Hopkinton,5781,6,5,1
New Hampshire,Hudson,25748,67,51,16
New Hampshire,Jackson,863,4,4,0
New Hampshire,Jaffrey,5258,12,11,1
New Hampshire,Keene,22707,51,40,11
New Hampshire,Kensington,2107,6,5,1
New Hampshire,Kingston,6500,7,6,1
New Hampshire,Laconia,16669,54,45,9
New Hampshire,Lancaster,3229,9,7,2
New Hampshire,Lebanon,13709,46,33,13
New Hampshire,Lee,4601,9,8,1
New Hampshire,Lincoln,1771,16,10,6
New Hampshire,Lisbon,1577,3,3,0
New Hampshire,Litchfield,8682,14,12,2
New Hampshire,Littleton,5862,15,13,2
New Hampshire,Londonderry,26812,69,56,13
New Hampshire,Loudon,5675,6,5,1
New Hampshire,Lyme,1671,2,2,0
New Hampshire,Madison,2618,4,4,0
New Hampshire,Manchester,113018,279,225,54
New Hampshire,Marlborough,2078,2,2,0
New Hampshire,Mason,1438,3,3,0
New Hampshire,Meredith,6484,17,13,4
New Hampshire,Merrimack,26602,52,39,13
New Hampshire,Middleton,1845,4,4,0
New Hampshire,Milford,16561,32,27,5
New Hampshire,Milton,4633,7,6,1
New Hampshire,Mont Vernon,2686,4,4,0
New Hampshire,Moultonborough,4198,9,8,1
New Hampshire,Nashua,89671,233,174,59
New Hampshire,New Boston,5966,10,9,1
New Hampshire,Newbury,2246,5,5,0
New Hampshire,New Castle,981,4,4,0
New Hampshire,New Durham,2715,5,5,0
New Hampshire,Newfields,1744,5,4,1
New Hampshire,New Hampton,2231,5,4,1
New Hampshire,Newington,821,12,11,1
New Hampshire,New Ipswich,5425,6,5,1
New Hampshire,New London,4300,14,9,5
New Hampshire,Newmarket,9192,20,13,7
New Hampshire,Newport,6342,16,11,5
New Hampshire,Newton,4969,7,6,1
New Hampshire,Northfield,4956,9,8,1
New Hampshire,North Hampton,4513,13,12,1
New Hampshire,Northumberland,2123,3,3,0
New Hampshire,Northwood,4321,9,8,1
New Hampshire,Nottingham,5182,9,8,1
New Hampshire,Orford,1308,1,1,0
New Hampshire,Ossipee,4389,10,9,1
New Hampshire,Pelham,14373,30,23,7
New Hampshire,Pembroke,7212,14,12,2
New Hampshire,Peterborough,6736,14,12,2
New Hampshire,Pittsburg,815,2,2,0
New Hampshire,Pittsfield,4126,6,6,0
New Hampshire,Plainfield,2404,2,2,0
New Hampshire,Plaistow,7738,22,15,7
New Hampshire,Plymouth,6850,18,11,7
New Hampshire,Portsmouth,22032,84,65,19
New Hampshire,Raymond,10583,24,16,8
New Hampshire,Rindge,6100,9,8,1
New Hampshire,Rochester,31762,72,57,15
New Hampshire,Rollinsford,2596,4,4,0
New Hampshire,Rye,5495,11,10,1
New Hampshire,Salem,29943,79,63,16
New Hampshire,Sanbornton,3000,7,6,1
New Hampshire,Sandown,6620,8,7,1
New Hampshire,Sandwich,1362,2,2,0
New Hampshire,Seabrook,8871,30,25,5
New Hampshire,Somersworth,12005,34,27,7
New Hampshire,South Hampton,829,2,2,0
New Hampshire,Springfield,1344,2,2,0
New Hampshire,Strafford,4242,6,6,0
New Hampshire,Stratham,7521,12,11,1
New Hampshire,Sugar Hill,579,2,2,0
New Hampshire,Sunapee,3501,6,5,1
New Hampshire,Swanzey,7219,12,11,1
New Hampshire,Tamworth,3101,3,3,0
New Hampshire,Thornton,2541,7,6,1
New Hampshire,Tilton,3546,20,16,4
New Hampshire,Troy,2100,2,2,0
New Hampshire,Tuftonboro,2425,4,4,0
New Hampshire,Wakefield,5799,14,12,2
New Hampshire,Warner,2931,5,4,1
New Hampshire,Washington,1101,1,1,0
New Hampshire,Waterville Valley,240,6,6,0
New Hampshire,Weare,9124,12,11,1
New Hampshire,Webster,1962,2,2,0
New Hampshire,Whitefield,2200,7,6,1
New Hampshire,Wilton,3801,7,7,0
New Hampshire,Winchester,4213,9,8,1
New Hampshire,Windham,15017,28,21,7
New Hampshire,Wolfeboro,6433,19,13,6
New Hampshire,Woodstock,1364,6,6,0
New Jersey,Aberdeen Township,19471,49,42,7
New Jersey,Absecon,8856,30,24,6
New Jersey,Allendale,6751,20,15,5
New Jersey,Allenhurst,482,13,9,4
New Jersey,Allentown,1770,7,6,1
New Jersey,Alpine,1845,12,12,0
New Jersey,Andover Township,5826,17,12,5
New Jersey,Asbury Park,15331,93,89,4
New Jersey,Atlantic City,37550,224,190,34
New Jersey,Atlantic Highlands,4348,19,14,5
New Jersey,Audubon,8608,18,17,1
New Jersey,Avalon,1225,28,21,7
New Jersey,Avon-by-the-Sea,1771,12,12,0
New Jersey,Barnegat Township,23998,55,53,2
New Jersey,Barrington,6601,17,15,2
New Jersey,Bay Head,979,10,9,1
New Jersey,Bayonne,65013,247,184,63
New Jersey,Beach Haven,1210,13,12,1
New Jersey,Beachwood,11357,22,20,2
New Jersey,Bedminster Township,7963,18,16,2
New Jersey,Belleville,36533,101,96,5
New Jersey,Bellmawr,11318,22,21,1
New Jersey,Belmar,5518,30,24,6
New Jersey,Belvidere,2548,7,6,1
New Jersey,Bergenfield,27347,51,43,8
New Jersey,Berkeley Heights Township,13371,30,27,3
New Jersey,Berkeley Township,42168,92,70,22
New Jersey,Berlin,7517,19,18,1
New Jersey,Berlin Township,5721,19,18,1
New Jersey,Bernards Township,27130,41,38,3
New Jersey,Bernardsville,7593,26,20,6
New Jersey,Beverly,2472,8,8,0
New Jersey,Blairstown Township,5665,9,8,1
New Jersey,Bloomfield,50221,150,126,24
New Jersey,Bloomingdale,8098,20,19,1
New Jersey,Bogota,8342,20,15,5
New Jersey,Boonton,8977,25,23,2
New Jersey,Boonton Township,4228,13,13,0
New Jersey,Bordentown City,3778,14,14,0
New Jersey,Bordentown Township,11974,25,23,2
New Jersey,Bound Brook,10174,31,25,6
New Jersey,Bradley Beach,4131,22,18,4
New Jersey,Branchburg Township,14526,29,27,2
New Jersey,Brick Township,76326,211,141,70
New Jersey,Bridgeton,24032,74,61,13
New Jersey,Bridgewater Township,44006,81,73,8
New Jersey,Brielle,4656,17,16,1
New Jersey,Brigantine,8566,45,35,10
New Jersey,Brooklawn,1892,8,8,0
New Jersey,Burlington City,9849,37,33,4
New Jersey,Burlington Township,22595,56,47,9
New Jersey,Butler,7643,17,16,1
New Jersey,Byram Township,7880,14,14,0
New Jersey,Caldwell,7938,18,18,0
New Jersey,Camden County Police Department,73127,423,386,37
New Jersey,Cape May,3401,27,22,5
New Jersey,Carlstadt,6126,28,26,2
New Jersey,Carney's Point Township,7632,20,19,1
New Jersey,Carteret,23444,74,64,10
New Jersey,Cedar Grove Township,12483,31,30,1
New Jersey,Chatham,8586,25,21,4
New Jersey,Chatham Township,10071,24,22,2
New Jersey,Cherry Hill Township,71220,164,135,29
New Jersey,Chesilhurst,1615,10,9,1
New Jersey,Chesterfield Township,7557,12,11,1
New Jersey,Chester Township,7640,24,23,1
New Jersey,Cinnaminson Township,16429,28,28,0
New Jersey,Clark Township,16026,47,36,11
New Jersey,Clayton,8790,16,15,1
New Jersey,Clementon,4950,12,12,0
New Jersey,Cliffside Park,26400,44,43,1
New Jersey,Clifton,85058,194,158,36
New Jersey,Clinton,2684,10,10,0
New Jersey,Clinton Township,12465,24,23,1
New Jersey,Closter,8511,21,20,1
New Jersey,Collingswood,13864,31,27,4
New Jersey,Colts Neck Township,9786,27,26,1
New Jersey,Cranbury Township,4086,22,21,1
New Jersey,Cranford Township,24186,66,52,14
New Jersey,Cresskill,8672,29,24,5
New Jersey,Deal,715,22,18,4
New Jersey,Delanco Township,4448,13,12,1
New Jersey,Delaware Township,4410,8,7,1
New Jersey,Delran Township,16444,32,28,4
New Jersey,Demarest,4884,16,16,0
New Jersey,Denville Township,16400,42,33,9
New Jersey,Deptford Township,30275,73,67,6
New Jersey,Dover,17654,43,39,4
New Jersey,Dumont,17507,40,32,8
New Jersey,Dunellen,7192,19,19,0
New Jersey,Eastampton Township,6156,20,19,1
New Jersey,East Brunswick Township,47573,106,83,23
New Jersey,East Greenwich Township,10834,22,21,1
New Jersey,East Hanover Township,10881,38,34,4
New Jersey,East Newark,2614,7,7,0
New Jersey,East Orange,64320,243,192,51
New Jersey,East Rutherford,9767,39,38,1
New Jersey,East Windsor Township,27265,48,43,5
New Jersey,Eatontown,12124,49,37,12
New Jersey,Edgewater,13573,31,29,2
New Jersey,Edgewater Park Township,8618,17,15,2
New Jersey,Edison Township,99584,231,184,47
New Jersey,Egg Harbor City,4031,15,14,1
New Jersey,Egg Harbor Township,42110,133,86,47
New Jersey,Elizabeth,129518,407,312,95
New Jersey,Elk Township,4168,12,11,1
New Jersey,Elmer,1299,2,2,0
New Jersey,Elmwood Park,19994,54,49,5
New Jersey,Emerson,7610,25,22,3
New Jersey,Englewood,28514,101,77,24
New Jersey,Englewood Cliffs,5351,22,21,1
New Jersey,Englishtown,1921,7,7,0
New Jersey,Essex Fells,2083,13,13,0
New Jersey,Evesham Township,45148,88,79,9
New Jersey,Ewing Township,36325,97,77,20
New Jersey,"Fairfield Township, Essex County",7468,43,39,4
New Jersey,Fair Haven,5696,13,13,0
New Jersey,Fair Lawn,32910,69,60,9
New Jersey,Fairview,14209,36,33,3
New Jersey,Fanwood,7732,17,16,1
New Jersey,Far Hills,903,6,6,0
New Jersey,Flemington,4577,15,15,0
New Jersey,Florence Township,12527,31,29,2
New Jersey,Florham Park,11455,38,32,6
New Jersey,Fort Lee,38921,112,93,19
New Jersey,Franklin,4684,17,16,1
New Jersey,Franklin Lakes,11166,33,26,7
New Jersey,"Franklin Township, Gloucester County",16226,41,37,4
New Jersey,"Franklin Township, Hunterdon County",3557,6,6,0
New Jersey,"Franklin Township, Somerset County",66138,124,103,21
New Jersey,Freehold Borough,11643,34,30,4
New Jersey,Freehold Township,34456,72,68,4
New Jersey,Frenchtown,1347,3,2,1
New Jersey,Galloway Township,35444,83,63,20
New Jersey,Garfield,31908,68,59,9
New Jersey,Garwood,4360,20,16,4
New Jersey,Gibbsboro,2210,9,9,0
New Jersey,Glassboro,20461,55,50,5
New Jersey,Glen Ridge,7574,29,23,6
New Jersey,Glen Rock,11705,25,23,2
New Jersey,Gloucester City,11182,38,36,2
New Jersey,Gloucester Township,63755,150,128,22
New Jersey,Green Brook Township,7004,23,22,1
New Jersey,"Greenwich Township, Gloucester County",4777,17,16,1
New Jersey,"Greenwich Township, Warren County",5415,12,12,0
New Jersey,Guttenberg,11100,29,26,3
New Jersey,Hackettstown,9316,20,19,1
New Jersey,Haddonfield,11274,25,22,3
New Jersey,Haddon Heights,7527,16,15,1
New Jersey,Haddon Township,14510,27,25,2
New Jersey,Haledon,8280,20,20,0
New Jersey,Hamburg,3110,9,8,1
New Jersey,"Hamilton Township, Atlantic County",25654,82,56,26
New Jersey,"Hamilton Township, Mercer County",86805,202,168,34
New Jersey,Hammonton,13845,36,30,6
New Jersey,Hanover Township,14290,39,32,7
New Jersey,Harding Township,3750,15,14,1
New Jersey,Hardyston Township,7744,23,17,6
New Jersey,Harrington Park,4730,11,11,0
New Jersey,Harrison,20937,50,41,9
New Jersey,Harrison Township,13178,24,23,1
New Jersey,Harvey Cedars,345,9,9,0
New Jersey,Hasbrouck Heights,11988,31,29,2
New Jersey,Haworth,3391,13,12,1
New Jersey,Hawthorne,18728,39,33,6
New Jersey,Hazlet Township,19593,45,42,3
New Jersey,High Bridge,3385,7,7,0
New Jersey,Highland Park,13666,35,28,7
New Jersey,Highlands,4682,16,15,1
New Jersey,Hightstown,5273,14,13,1
New Jersey,Hillsborough Township,40210,63,54,9
New Jersey,Hillsdale,10308,25,20,5
New Jersey,Hillside Township,21995,74,64,10
New Jersey,Hi-Nella,856,12,12,0
New Jersey,Hoboken,52902,148,133,15
New Jersey,Ho-Ho-Kus,4058,20,16,4
New Jersey,Holland Township,5074,8,7,1
New Jersey,Holmdel Township,16726,51,43,8
New Jersey,Hopatcong,14086,35,29,6
New Jersey,Hopewell Township,17641,38,29,9
New Jersey,Howell Township,52048,129,114,15
New Jersey,Independence Township,5386,10,9,1
New Jersey,Irvington,54306,201,144,57
New Jersey,Island Heights,1685,7,7,0
New Jersey,Jackson Township,58120,110,90,20
New Jersey,Jamesburg,5878,21,16,5
New Jersey,Jefferson Township,20626,42,34,8
New Jersey,Jersey City,263273,1284,1005,279
New Jersey,Keansburg,9582,42,33,9
New Jersey,Kearny,41037,114,108,6
New Jersey,Kenilworth,8211,32,27,5
New Jersey,Keyport,6951,22,20,2
New Jersey,Kinnelon,9859,17,16,1
New Jersey,Lacey Township,29524,56,42,14
New Jersey,Lakehurst,2718,12,10,2
New Jersey,Lakewood Township,108023,189,148,41
New Jersey,Lambertville,3788,12,10,2
New Jersey,Laurel Springs,1860,7,7,0
New Jersey,Lavallette,1868,14,12,2
New Jersey,Lawnside,2872,10,9,1
New Jersey,"Lawrence Township, Mercer County",32282,67,60,7
New Jersey,Lebanon Township,6055,11,10,1
New Jersey,Leonia,9033,22,19,3
New Jersey,Lincoln Park,10051,30,24,6
New Jersey,Linden,42515,184,140,44
New Jersey,Lindenwold,17206,47,44,3
New Jersey,Linwood,6612,18,17,1
New Jersey,Little Egg Harbor Township,21928,55,43,12
New Jersey,Little Falls Township,14463,34,28,6
New Jersey,Little Ferry,10736,30,25,5
New Jersey,Little Silver,5761,20,15,5
New Jersey,Livingston Township,30372,87,70,17
New Jersey,Lodi,24343,50,47,3
New Jersey,Logan Township,5847,23,22,1
New Jersey,Long Beach Township,3075,47,35,12
New Jersey,Long Branch,30175,118,94,24
New Jersey,Long Hill Township,8389,25,23,2
New Jersey,Longport,846,12,12,0
New Jersey,Lopatcong Township,8419,17,16,1
New Jersey,Lower Alloways Creek Township,1660,12,12,0
New Jersey,Lower Township,21177,57,51,6
New Jersey,Lumberton Township,12153,26,24,2
New Jersey,Lyndhurst Township,23169,55,52,3
New Jersey,Madison,17850,35,27,8
New Jersey,Magnolia,4259,12,12,0
New Jersey,Mahwah Township,26201,60,51,9
New Jersey,Manalapan Township,39353,62,58,4
New Jersey,Manasquan,5796,22,17,5
New Jersey,Manchester Township,43856,123,74,49
New Jersey,"Mansfield Township, Burlington County",8527,16,15,1
New Jersey,"Mansfield Township, Warren County",7325,16,15,1
New Jersey,Mantoloking,245,11,10,1
New Jersey,Mantua Township,14769,29,27,2
New Jersey,Manville,10116,26,23,3
New Jersey,Maple Shade Township,18402,38,34,4
New Jersey,Maplewood Township,25531,75,63,12
New Jersey,Margate City,5813,37,28,9
New Jersey,Marlboro Township,39593,115,89,26
New Jersey,Matawan,8613,25,24,1
New Jersey,Maywood,9610,26,22,4
New Jersey,Medford Lakes,3888,11,10,1
New Jersey,Medford Township,23433,39,35,4
New Jersey,Mendham,4825,15,14,1
New Jersey,Mendham Township,5632,16,15,1
New Jersey,Merchantville,3688,16,14,2
New Jersey,Metuchen,14639,34,29,5
New Jersey,Middlesex Borough,13669,32,29,3
New Jersey,Middle Township,18093,66,55,11
New Jersey,Middletown Township,65170,118,108,10
New Jersey,Midland Park,7214,18,17,1
New Jersey,Millburn Township,20053,64,58,6
New Jersey,Milltown,6967,19,16,3
New Jersey,Millville,27272,87,76,11
New Jersey,Monmouth Beach,3235,10,9,1
New Jersey,"Monroe Township, Gloucester County",36893,68,64,4
New Jersey,"Monroe Township, Middlesex County",45653,87,66,21
New Jersey,Montclair,38621,130,107,23
New Jersey,Montgomery Township,23268,40,34,6
New Jersey,Montvale,8643,26,24,2
New Jersey,Montville Township,20982,42,37,5
New Jersey,Moonachie,2700,22,19,3
New Jersey,Moorestown Township,20491,36,31,5
New Jersey,Morris Plains,6335,19,17,2
New Jersey,Morristown,19337,61,57,4
New Jersey,Morris Township,22100,54,49,5
New Jersey,Mountain Lakes,4224,14,13,1
New Jersey,Mountainside,6902,26,21,5
New Jersey,Mount Arlington,5944,16,15,1
New Jersey,Mount Ephraim,4573,14,13,1
New Jersey,Mount Holly Township,9546,27,24,3
New Jersey,Mount Laurel Township,41179,82,75,7
New Jersey,Mount Olive Township,28973,60,50,10
New Jersey,Mullica Township,5825,15,14,1
New Jersey,Neptune City,4573,19,18,1
New Jersey,Neptune Township,27320,88,76,12
New Jersey,Netcong,3116,13,12,1
New Jersey,Newark,282242,1407,1062,345
New Jersey,New Brunswick,55701,164,146,18
New Jersey,New Hanover Township,7859,3,3,0
New Jersey,New Milford,16417,43,41,2
New Jersey,New Providence,13741,27,25,2
New Jersey,Newton,8008,27,22,5
New Jersey,North Arlington,15695,39,31,8
New Jersey,North Bergen Township,60567,136,116,20
New Jersey,North Brunswick Township,41383,98,81,17
New Jersey,North Caldwell,6666,21,16,5
New Jersey,Northfield,7979,23,22,1
New Jersey,North Haledon,8382,28,22,6
New Jersey,North Hanover Township,7443,11,10,1
New Jersey,North Plainfield,21279,53,45,8
New Jersey,Northvale,4955,14,14,0
New Jersey,North Wildwood,3731,37,29,8
New Jersey,Norwood,5792,17,16,1
New Jersey,Nutley Township,28408,83,70,13
New Jersey,Oakland,12929,34,28,6
New Jersey,Oaklyn,3942,17,16,1
New Jersey,Ocean City,10893,82,66,16
New Jersey,Ocean Gate,2042,12,11,1
New Jersey,Oceanport,5708,16,15,1
New Jersey,"Ocean Township, Monmouth County",26462,74,61,13
New Jersey,"Ocean Township, Ocean County",9184,31,21,10
New Jersey,Ogdensburg,2237,6,6,0
New Jersey,Old Bridge Township,65537,122,101,21
New Jersey,Old Tappan,5904,14,13,1
New Jersey,Oradell,8137,24,23,1
New Jersey,Orange City,30541,163,134,29
New Jersey,Palisades Park,20818,42,39,3
New Jersey,Palmyra,7114,17,16,1
New Jersey,Paramus,26222,125,101,24
New Jersey,Park Ridge,8688,21,20,1
New Jersey,Parsippany-Troy Hills Township,51317,128,99,29
New Jersey,Passaic,69610,194,159,35
New Jersey,Paterson,144947,430,403,27
New Jersey,Paulsboro,5820,21,19,2
New Jersey,Peapack-Gladstone,2606,9,8,1
New Jersey,Pemberton Borough,1315,6,6,0
New Jersey,Pemberton Township,26875,43,38,5
New Jersey,Pennington,2575,6,6,0
New Jersey,Pennsauken Township,35698,96,89,7
New Jersey,Penns Grove,4721,15,14,1
New Jersey,Pennsville Township,12315,23,21,2
New Jersey,Pequannock Township,14887,36,31,5
New Jersey,Perth Amboy,51384,141,122,19
New Jersey,Phillipsburg,14136,38,37,1
New Jersey,Pine Beach,2192,7,6,1
New Jersey,Pine Hill,10427,24,21,3
New Jersey,Pine Valley,11,6,6,0
New Jersey,Piscataway Township,56870,95,77,18
New Jersey,Pitman,8701,19,18,1
New Jersey,Plainfield,50333,142,121,21
New Jersey,Plainsboro Township,22847,48,36,12
New Jersey,Pleasantville,20135,71,65,6
New Jersey,Plumsted Township,8598,15,14,1
New Jersey,Pohatcong Township,3158,16,15,1
New Jersey,Point Pleasant,18842,40,31,9
New Jersey,Point Pleasant Beach,4543,31,25,6
New Jersey,Pompton Lakes,10961,29,24,5
New Jersey,Princeton,31458,55,51,4
New Jersey,Prospect Park,5834,19,18,1
New Jersey,Rahway,30157,87,76,11
New Jersey,Ramsey,14904,41,34,7
New Jersey,Randolph Township,25311,41,35,6
New Jersey,Raritan,7888,22,21,1
New Jersey,Raritan Township,22402,41,38,3
New Jersey,Readington Township,15813,25,23,2
New Jersey,Red Bank,11929,45,39,6
New Jersey,Ridgefield,11171,30,28,2
New Jersey,Ridgefield Park,12904,44,37,7
New Jersey,Ridgewood,25036,50,45,5
New Jersey,Ringwood,12177,26,21,5
New Jersey,Riverdale,4198,22,17,5
New Jersey,River Edge,11431,27,24,3
New Jersey,Riverside Township,7788,18,18,0
New Jersey,Riverton,2676,6,6,0
New Jersey,River Vale Township,10007,24,23,1
New Jersey,Robbinsville Township,14628,37,29,8
New Jersey,Rochelle Park Township,5566,26,22,4
New Jersey,Rockaway,6250,16,15,1
New Jersey,Rockaway Township,26046,61,50,11
New Jersey,Roseland,5829,25,24,1
New Jersey,Roselle,21867,66,53,13
New Jersey,Roselle Park,13604,36,34,2
New Jersey,Roxbury Township,22439,45,42,3
New Jersey,Rumson,6675,21,16,5
New Jersey,Runnemede,8273,19,18,1
New Jersey,Rutherford,18307,43,41,2
New Jersey,Saddle Brook Township,13533,35,33,2
New Jersey,Saddle River,3170,23,18,5
New Jersey,Salem,4661,19,17,2
New Jersey,Sayreville,44282,103,88,15
New Jersey,Scotch Plains Township,24313,52,49,3
New Jersey,Sea Bright,1325,17,11,6
New Jersey,Sea Girt,1758,13,12,1
New Jersey,Sea Isle City,2019,28,22,6
New Jersey,Seaside Heights,2917,28,25,3
New Jersey,Seaside Park,1541,13,12,1
New Jersey,Secaucus,22535,89,74,15
New Jersey,Ship Bottom,1156,12,10,2
New Jersey,Shrewsbury,4082,20,16,4
New Jersey,Somerdale,5511,16,15,1
New Jersey,Somers Point,10108,38,30,8
New Jersey,Somerville,12084,33,31,2
New Jersey,South Amboy,9235,34,28,6
New Jersey,South Bound Brook,4526,14,13,1
New Jersey,South Brunswick Township,45877,106,82,24
New Jersey,South Hackensack Township,2438,24,21,3
New Jersey,South Orange Village,16732,52,46,6
New Jersey,South Plainfield,24100,72,58,14
New Jersey,South River,15731,40,31,9
New Jersey,South Toms River,3701,13,12,1
New Jersey,Sparta Township,18467,44,32,12
New Jersey,Spotswood,8216,29,25,4
New Jersey,"Springfield Township, Burlington County",3241,11,10,1
New Jersey,"Springfield Township, Union County",17639,49,45,4
New Jersey,Spring Lake,2894,14,14,0
New Jersey,Spring Lake Heights,4502,15,15,0
New Jersey,Stafford Township,28029,72,55,17
New Jersey,Stanhope,3275,9,8,1
New Jersey,Stone Harbor,804,19,17,2
New Jersey,Stratford,6937,14,14,0
New Jersey,Summit,21917,51,47,4
New Jersey,Surf City,1203,10,10,0
New Jersey,Teaneck Township,40290,108,93,15
New Jersey,Tenafly,14427,40,34,6
New Jersey,Tewksbury Township,5754,13,12,1
New Jersey,Tinton Falls,17388,44,42,2
New Jersey,Toms River Township,94561,207,162,45
New Jersey,Totowa,10777,32,28,4
New Jersey,Trenton,82909,323,255,68
New Jersey,Tuckerton,3396,14,13,1
New Jersey,Union Beach,5210,21,17,4
New Jersey,Union City,68055,199,162,37
New Jersey,Union Township,58613,187,135,52
New Jersey,Upper Saddle River,8199,21,17,4
New Jersey,Ventnor City,9815,50,37,13
New Jersey,Vernon Township,21819,41,33,8
New Jersey,Verona,13368,35,29,6
New Jersey,Vineland,59288,153,120,33
New Jersey,Voorhees Township,29130,62,52,10
New Jersey,Waldwick,10156,26,21,5
New Jersey,Wallington,11499,24,23,1
New Jersey,Wall Township,25489,87,71,16
New Jersey,Wanaque,11828,28,23,5
New Jersey,Warren Township,15689,37,30,7
New Jersey,"Washington Township, Bergen County",9171,26,21,5
New Jersey,"Washington Township, Gloucester County",47551,92,84,8
New Jersey,"Washington Township, Morris County",18086,30,29,1
New Jersey,"Washington Township, Warren County",6323,30,28,2
New Jersey,Watchung,6018,36,30,6
New Jersey,Waterford Township,10675,26,25,1
New Jersey,Wayne Township,53162,146,118,28
New Jersey,Weehawken Township,14874,66,55,11
New Jersey,Westampton Township,8632,26,23,3
New Jersey,West Amwell Township,2728,6,6,0
New Jersey,West Caldwell Township,10841,31,26,5
New Jersey,West Deptford Township,20878,45,42,3
New Jersey,Westfield,29389,74,61,13
New Jersey,West Long Branch,7860,22,21,1
New Jersey,West Milford Township,26310,52,45,7
New Jersey,West New York,52977,133,120,13
New Jersey,West Orange,47666,112,98,14
New Jersey,Westville,4123,14,13,1
New Jersey,West Wildwood,545,6,6,0
New Jersey,West Windsor Township,27944,61,49,12
New Jersey,Westwood,11079,31,26,5
New Jersey,Wharton,6343,23,21,2
New Jersey,Wildwood,4908,51,41,10
New Jersey,Wildwood Crest,3024,28,25,3
New Jersey,Willingboro Township,32048,71,63,8
New Jersey,Winfield Township,1504,9,9,0
New Jersey,Winslow Township,38460,80,74,6
New Jersey,Woodbridge Township,100119,263,203,60
New Jersey,Woodbury,9744,30,27,3
New Jersey,Woodbury Heights,2949,8,7,1
New Jersey,Woodcliff Lake,5845,20,19,1
New Jersey,Woodland Park,12653,32,27,5
New Jersey,Woodlynne,2906,8,6,2
New Jersey,Wood-Ridge,9489,28,24,4
New Jersey,Woodstown,3429,10,9,1
New Jersey,Woolwich Township,13278,29,28,1
New Jersey,Wyckoff Township,16950,27,27,0
New Mexico,Artesia,12451,45,25,20
New Mexico,Capitan,1425,4,3,1
New Mexico,Clovis,38326,75,50,25
New Mexico,Cuba,760,5,4,1
New Mexico,Dexter,1241,6,5,1
New Mexico,Farmington,44191,164,124,40
New Mexico,Hobbs,39751,131,89,42
New Mexico,Las Vegas,12799,54,43,11
New Mexico,Los Alamos,19581,72,34,38
New Mexico,Los Lunas,16170,69,34,35
New Mexico,Magdalena,872,3,3,0
New Mexico,Moriarty,1846,10,9,1
New Mexico,Mountainair,866,6,5,1
New Mexico,Peralta,3576,14,13,1
New Mexico,Roswell,47451,94,72,22
New Mexico,Santa Clara,1746,4,3,1
New Mexico,San Ysidro,202,3,2,1
New Mexico,Springer,892,1,1,0
New Mexico,Sunland Park,18437,25,20,5
New Mexico,Tatum,833,9,4,5
New Mexico,Texico,1061,2,2,0
New York,Addison Town and Village,2458,3,3,0
New York,Akron Village,2852,1,1,0
New York,Albany,96318,371,295,76
New York,Albion Village,5698,13,12,1
New York,Alfred Village,3970,5,5,0
New York,Altamont Village,1664,1,1,0
New York,Amherst Town,121304,183,155,28
New York,Amityville Village,9387,22,21,1
New York,Amsterdam,17675,42,38,4
New York,Arcade Village,1919,6,6,0
New York,Ardsley Village,4515,19,19,0
New York,Asharoken Village,644,3,3,0
New York,Attica Village,2389,5,5,0
New York,Avon Village,3272,5,5,0
New York,Baldwinsville Village,7895,13,12,1
New York,Ballston Spa Village,5204,4,4,0
New York,Batavia,14278,36,33,3
New York,Bath Village,5438,11,10,1
New York,Beacon,13984,36,33,3
New York,Bedford Town,17672,43,38,5
New York,Bethlehem Town,35039,53,38,15
New York,Blooming Grove Town,11822,17,15,2
New York,Bolivar Village,968,1,1,0
New York,Brant Town,2056,1,1,0
New York,Briarcliff Manor Village,8126,20,20,0
New York,Bronxville Village,6422,23,21,2
New York,Buffalo,254627,927,752,175
New York,Cairo Town,6390,2,2,0
New York,Cambridge Village,1803,3,3,0
New York,Camden Village,2151,2,2,0
New York,Camillus Town and Village,24098,28,24,4
New York,Canajoharie Village,2122,5,5,0
New York,Canandaigua,10112,27,25,2
New York,Canastota Village,4518,6,6,0
New York,Canisteo Village,2120,3,3,0
New York,Canton Village,6516,11,10,1
New York,Carmel Town,34093,39,32,7
New York,Carthage Village,3250,4,4,0
New York,Catskill Village,3787,16,14,2
New York,Cayuga Heights Village,3589,7,6,1
New York,Cazenovia Village,2851,6,5,1
New York,Central Square Village,1740,4,4,0
New York,Centre Island Village,409,6,6,0
New York,Cheektowaga Town,76536,156,119,37
New York,Chester Town,8095,15,15,0
New York,Chester Village,4108,15,14,1
New York,Chittenango Village,4826,2,1,1
New York,Clayton Village,1816,2,2,0
New York,Cobleskill Village,4323,11,11,0
New York,Coeymans Town,7247,3,2,1
New York,Cohoes,16746,34,31,3
New York,Colchester Town,1947,2,2,0
New York,Colonie Town,79082,144,109,35
New York,Corning,10469,25,21,4
New York,Cornwall-on-Hudson Village,2911,3,3,0
New York,Cornwall Town,9538,11,9,2
New York,Cortland,18615,46,44,2
New York,Cuba Town,3059,5,5,0
New York,Deerpark Town,7732,4,4,0
New York,Delhi Village,2935,5,5,0
New York,Depew Village,14965,33,27,6
New York,DeWitt Town,24947,46,43,3
New York,Dobbs Ferry Village,11037,29,27,2
New York,Dolgeville Village,2055,4,4,0
New York,Dryden Village,2066,4,4,0
New York,Dunkirk,11673,38,37,1
New York,East Aurora-Aurora Town,13748,21,16,5
New York,Eastchester Town,19991,50,48,2
New York,East Fishkill Town,29578,33,26,7
New York,East Greenbush Town,16186,33,24,9
New York,East Hampton Town,19927,92,65,27
New York,East Hampton Village,1140,29,24,5
New York,Eden Town,7602,2,1,1
New York,Ellicott Town,4981,13,13,0
New York,Ellicottville,1563,4,4,0
New York,Elmira,26820,79,70,9
New York,Elmira Heights Village,3774,9,9,0
New York,Elmira Town,5529,4,4,0
New York,Elmsford Village,5279,24,21,3
New York,Evans Town,16061,25,19,6
New York,Fallsburg Town,12264,21,21,0
New York,Florida Village,2931,1,1,0
New York,Fort Edward Village,3256,5,5,0
New York,Fort Plain Village,2212,3,3,0
New York,Frankfort Town,4752,3,3,0
New York,Fredonia Village,10205,18,14,4
New York,Freeport Village,42962,112,100,12
New York,Fulton City,11017,36,35,1
New York,Garden City Village,22465,65,51,14
New York,Geddes Town,10002,18,16,2
New York,Geneseo Village,8130,9,9,0
New York,Geneva,12569,35,33,2
New York,Glen Cove,27186,58,53,5
New York,Glens Falls,14215,32,30,2
New York,Glenville Town,21609,25,24,1
New York,Gloversville,14656,37,34,3
New York,Goshen Town,8938,6,6,0
New York,Goshen Village,5361,21,18,3
New York,Gouverneur Village,3637,8,5,3
New York,Granville Village,2428,6,6,0
New York,Great Neck Estates Village,2892,17,14,3
New York,Greene Village,1400,1,1,0
New York,Greenwich Village,1708,1,1,0
New York,Greenwood Lake Village,3080,4,4,0
New York,Groton Village,2211,1,1,0
New York,Guilderland Town,34103,53,37,16
New York,Hamburg Town,46513,64,62,2
New York,Hamburg Village,9744,14,13,1
New York,Hamilton Village,4077,5,5,0
New York,Harriman Village,2455,7,7,0
New York,Harrison Town,29110,79,68,11
New York,Hastings-on-Hudson Village,7853,21,21,0
New York,Hempstead Village,55230,142,113,29
New York,Herkimer Village,7212,19,19,0
New York,Holley Village,1669,1,1,0
New York,Homer Village,3081,5,4,1
New York,Horseheads Village,6325,10,10,0
New York,Hudson Falls Village,7029,12,12,0
New York,Hunter Town,2620,3,3,0
New York,Huntington Bay Village,1436,4,4,0
New York,Hyde Park Town,20766,20,16,4
New York,Ilion Village,7613,18,17,1
New York,Irondequoit Town,49889,58,48,10
New York,Irvington Village,6478,23,23,0
New York,Ithaca,30927,69,61,8
New York,Jamestown,28842,70,60,10
New York,Johnstown,8183,24,23,1
New York,Kenmore Village,14968,29,25,4
New York,Kensington Village,1193,6,6,0
New York,Kent Town,13123,23,18,5
New York,Kings Point Village,5315,21,19,2
New York,Kingston,22682,74,69,5
New York,Lackawanna,17674,51,44,7
New York,Lake Placid Village,2339,16,14,2
New York,Lake Success Village,3161,27,24,3
New York,Lakewood-Busti,7125,11,10,1
New York,Lancaster Town,37633,65,50,15
New York,Larchmont Village,6112,25,23,2
New York,Le Roy Village,4246,7,7,0
New York,Lewisboro Town,12533,3,3,0
New York,Liberty Village,4182,19,17,2
New York,Little Falls,4604,12,11,1
New York,Liverpool Village,2191,4,4,0
New York,Lloyd Town,10484,12,10,2
New York,Lockport,20212,49,47,2
New York,Lowville Village,3297,6,6,0
New York,Lynbrook Village,19441,58,50,8
New York,Macedon Town and Village,8856,7,6,1
New York,Malone Village,5566,13,13,0
New York,Malverne Village,8482,22,22,0
New York,Mamaroneck Town,12017,37,36,1
New York,Mamaroneck Village,19154,58,50,8
New York,Manlius Town,24139,38,34,4
New York,Marlborough Town,8579,11,8,3
New York,Massena Village,10123,24,19,5
New York,Maybrook Village,3773,3,3,0
New York,Mechanicville,5018,10,10,0
New York,Medina Village,5613,13,12,1
New York,Menands Village,3850,14,11,3
New York,Middleport Village,1733,3,3,0
New York,Middletown,28194,79,68,11
New York,Mohawk Village,2507,4,4,0
New York,Monroe Village,8609,22,18,4
New York,Montgomery Town,9222,14,11,3
New York,Montgomery Village,4617,4,4,0
New York,Monticello Village,6338,22,20,2
New York,Moriah Town,4437,2,2,0
New York,Mount Morris Village,2765,3,3,0
New York,Mount Pleasant Town,26966,55,47,8
New York,Mount Vernon,67339,225,164,61
New York,Newark Village,8784,14,14,0
New York,New Berlin Town,1507,1,1,0
New York,Newburgh,28095,74,62,12
New York,Newburgh Town,31691,56,45,11
New York,New Castle Town,17824,41,38,3
New York,New Paltz Town and Village,14040,24,21,3
New York,New Windsor Town,27980,62,50,12
New York,New York,8300377,50083,34018,16065
New York,New York Mills Village,3200,4,4,0
New York,Niagara Falls,47474,154,137,17
New York,Niskayuna Town,22428,31,29,2
New York,North Castle Town,12266,34,32,2
New York,North Greenbush Town,12264,20,18,2
New York,Northport Village,7258,21,17,4
New York,Norwich,6474,20,20,0
New York,Ocean Beach Village,83,4,4,0
New York,Ogdensburg,10364,26,22,4
New York,Old Brookville Village,2196,34,26,8
New York,Old Westbury Village,4603,30,25,5
New York,Olean,13334,41,34,7
New York,Oneida,10849,28,24,4
New York,Oneonta City,13904,28,22,6
New York,Orchard Park Town,29653,47,36,11
New York,Ossining Village,24786,65,57,8
New York,Oswego City,17138,54,47,7
New York,Owego Village,3846,4,3,1
New York,Oxford Village,1372,2,2,0
New York,Oyster Bay Cove Village,4300,14,14,0
New York,Peekskill,24371,61,51,10
New York,Pelham Manor Village,5535,24,23,1
New York,Pelham Village,6956,29,26,3
New York,Penn Yan Village,4900,13,12,1
New York,Perry Village,3471,3,3,0
New York,Plattsburgh City,19460,48,42,6
New York,Pleasantville Village,7280,23,21,2
New York,Port Chester Village,29181,60,58,2
New York,Port Dickinson Village,1513,5,4,1
New York,Port Jervis,8526,31,30,1
New York,Portville Village,941,1,1,0
New York,Port Washington,19391,68,60,8
New York,Poughkeepsie,30480,115,89,26
New York,Poughkeepsie Town,38934,95,80,15
New York,Pound Ridge Town,5133,2,1,1
New York,Quogue Village,1019,15,14,1
New York,Rensselaer City,9149,35,28,7
New York,Riverhead Town,33461,94,79,15
New York,Rochester,205199,810,711,99
New York,Rockville Centre Village,24604,65,56,9
New York,Rome,31978,69,67,2
New York,Rosendale Town,5755,2,2,0
New York,Rotterdam Town,30071,44,40,4
New York,Rye,15692,41,37,4
New York,Rye Brook Village,9542,28,27,1
New York,Sag Harbor Village,2296,13,12,1
New York,Salamanca,5360,18,18,0
New York,Sands Point Village,2919,20,20,0
New York,Saranac Lake Village,5177,12,12,0
New York,Saugerties Town,18956,28,24,4
New York,Scarsdale Village,17953,44,39,5
New York,Schenectady,65176,174,150,24
New York,Schodack Town,11617,9,8,1
New York,Scotia Village,7631,14,13,1
New York,Shandaken Town,2921,4,4,0
New York,Shawangunk Town,13782,3,3,0
New York,Shelter Island Town,2419,11,10,1
New York,Sherrill,2964,3,3,0
New York,Sidney Village,3553,8,8,0
New York,Skaneateles Village,2466,2,2,0
New York,Sleepy Hollow Village,10064,27,27,0
New York,Solvay Village,6196,14,13,1
New York,Southampton Town,51162,144,99,45
New York,Southampton Village,3330,48,33,15
New York,South Glens Falls Village,3647,5,5,0
New York,Southold Town,19957,65,48,17
New York,Suffern Village,11037,25,21,4
New York,Syracuse,142011,493,422,71
New York,Tarrytown Village,11383,37,33,4
New York,Tonawanda,14700,34,28,6
New York,Tonawanda Town,56503,147,100,47
New York,Troy,49052,137,127,10
New York,Trumansburg Village,1709,1,1,0
New York,Tuckahoe Village,6554,26,23,3
New York,Tupper Lake Village,3420,8,8,0
New York,Tuxedo Park Village,598,4,3,1
New York,Tuxedo Town,2969,6,6,0
New York,Ulster Town,12626,28,24,4
New York,Walden Village,6666,15,12,3
New York,Wappingers Falls Village,5540,4,2,2
New York,Warsaw Village,3225,5,5,0
New York,Warwick Town,18459,35,30,5
New York,Washingtonville Village,5755,16,15,1
New York,Waterford Town and Village,8466,11,9,2
New York,Waterloo Village,4842,9,8,1
New York,Watertown,24624,65,62,3
New York,Watervliet,9863,23,22,1
New York,Watkins Glen Village,1874,5,5,0
New York,Waverly Village,4083,11,10,1
New York,Webb Town,1779,6,6,0
New York,Weedsport Village,1695,1,1,0
New York,Wellsville Village,4343,12,11,1
New York,Westfield Village,2941,6,6,0
New York,Westhampton Beach Village,1806,16,14,2
New York,West Seneca Town,45278,73,60,13
New York,White Plains,58240,211,201,10
New York,Whitesboro Village,3595,5,5,0
New York,Whitestown Town,8948,7,7,0
New York,Windham Town,1672,1,1,0
New York,Woodbury Town,11133,25,20,5
New York,Woodstock Town,5754,10,10,0
New York,Yonkers,200816,688,607,81
New York,Yorktown Town,36284,67,58,9
New York,Yorkville Village,2556,3,3,0
North Carolina,Aberdeen,8189,29,27,2
North Carolina,Ahoskie,4733,14,12,2
North Carolina,Albemarle,16287,48,41,7
North Carolina,Andrews,1854,5,5,0
North Carolina,Angier,5533,15,15,0
North Carolina,Apex,62320,114,95,19
North Carolina,Archdale,11521,31,25,6
North Carolina,Asheboro,25994,84,76,8
North Carolina,Asheville,93980,252,202,50
North Carolina,Atlantic Beach,1513,17,16,1
North Carolina,Ayden,5155,23,19,4
North Carolina,Badin,1973,5,5,0
North Carolina,Bailey,561,2,2,0
North Carolina,Bakersville,443,1,1,0
North Carolina,Bald Head Island,185,26,25,1
North Carolina,Banner Elk,1160,9,8,1
North Carolina,Beaufort,4481,19,18,1
North Carolina,Beech Mountain,325,14,10,4
North Carolina,Belhaven,1567,6,5,1
North Carolina,Belmont,12848,45,39,6
North Carolina,Benson,3995,17,16,1
North Carolina,Bessemer City,5605,15,14,1
North Carolina,Bethel,1614,4,4,0
North Carolina,Beulaville,1292,6,6,0
North Carolina,Biltmore Forest,1424,16,12,4
North Carolina,Biscoe,1713,9,8,1
North Carolina,Black Creek,770,3,3,0
North Carolina,Black Mountain,8197,23,19,4
North Carolina,Bladenboro,1599,6,6,0
North Carolina,Blowing Rock,1334,15,13,2
North Carolina,Boiling Spring Lakes,6396,14,14,0
North Carolina,Boiling Springs,4523,10,10,0
North Carolina,Boone,19975,47,36,11
North Carolina,Boonville,1139,3,3,0
North Carolina,Brevard,7954,27,23,4
North Carolina,Bridgeton,438,1,1,0
North Carolina,Broadway,1295,4,4,0
North Carolina,Bryson City,1455,7,6,1
North Carolina,Bunn,390,3,2,1
North Carolina,Burgaw,4182,15,15,0
North Carolina,Burlington,55003,176,133,43
North Carolina,Burnsville,1642,8,8,0
North Carolina,Butner,7887,38,32,6
North Carolina,Candor,815,4,4,0
North Carolina,Canton,4364,20,15,5
North Carolina,Cape Carteret,2069,7,7,0
North Carolina,Carolina Beach,6479,27,26,1
North Carolina,Carrboro,21377,38,35,3
North Carolina,Carthage,2582,11,10,1
North Carolina,Cary,174441,212,174,38
North Carolina,Caswell Beach,435,4,4,0
North Carolina,Chadbourn,1698,7,6,1
North Carolina,Chapel Hill,64853,120,95,25
North Carolina,Charlotte-Mecklenburg1,958358,2320,1749,571
North Carolina,Cherryville,6110,19,14,5
North Carolina,China Grove,4227,13,13,0
North Carolina,Chocowinity,789,3,3,0
North Carolina,Claremont,1414,8,8,0
North Carolina,Clayton,26087,49,46,3
North Carolina,Cleveland,874,4,4,0
North Carolina,Clinton,8431,28,24,4
North Carolina,Coats,2545,7,7,0
North Carolina,Columbus,998,9,8,1
North Carolina,Concord,98411,205,184,21
North Carolina,Conover,8567,28,25,3
North Carolina,Conway,718,2,2,0
North Carolina,Cooleemee,984,1,1,0
North Carolina,Cornelius,30904,75,57,18
North Carolina,Cramerton,4491,13,13,0
North Carolina,Creedmoor,4669,19,15,4
North Carolina,Dallas,4835,15,13,2
North Carolina,Davidson,13313,23,21,2
North Carolina,Dobson,1534,8,8,0
North Carolina,Drexel,1851,5,5,0
North Carolina,Duck,398,12,11,1
North Carolina,Dunn,9763,47,42,5
North Carolina,Durham,284925,679,507,172
North Carolina,East Bend,599,2,2,0
North Carolina,East Spencer,1552,8,8,0
North Carolina,Eden,14799,45,42,3
North Carolina,Edenton,4575,19,17,2
North Carolina,Elizabeth City,17652,71,61,10
North Carolina,Elizabethtown,3349,17,16,1
North Carolina,Elkin,4009,22,18,4
North Carolina,Elon,12609,21,20,1
North Carolina,Emerald Isle,3698,20,18,2
North Carolina,Enfield,2247,7,6,1
North Carolina,Erwin,5227,11,10,1
North Carolina,Fair Bluff,874,4,4,0
North Carolina,Fairmont,2585,9,9,0
North Carolina,Farmville,4775,24,19,5
North Carolina,Fayetteville,212033,528,372,156
North Carolina,Fletcher,8508,17,16,1
North Carolina,Forest City,7130,33,31,2
North Carolina,Four Oaks,2291,8,8,0
North Carolina,Foxfire Village,1057,3,3,0
North Carolina,Franklin,4130,19,18,1
North Carolina,Franklinton,2267,9,6,3
North Carolina,Fremont,1260,4,4,0
North Carolina,Fuquay-Varina,32091,55,48,7
North Carolina,Garner,32093,72,63,9
North Carolina,Garysburg,904,2,2,0
North Carolina,Gaston,1007,4,4,0
North Carolina,Gastonia,77918,189,166,23
North Carolina,Gibsonville,7437,19,18,1
North Carolina,Glen Alpine,1482,4,4,0
North Carolina,Goldsboro,34051,101,89,12
North Carolina,Graham,15801,42,39,3
North Carolina,Granite Falls,4654,18,14,4
North Carolina,Granite Quarry,3018,9,9,0
North Carolina,Greensboro,299887,746,643,103
North Carolina,Greenville,94372,243,195,48
North Carolina,Grifton,2689,7,7,0
North Carolina,Hamlet,6302,17,15,2
North Carolina,Havelock,19722,36,28,8
North Carolina,Haw River,2563,8,8,0
North Carolina,Henderson,14861,47,39,8
North Carolina,Hendersonville,14275,56,42,14
North Carolina,Hertford,2109,8,7,1
North Carolina,Hickory,41300,143,112,31
North Carolina,Highlands,988,14,13,1
North Carolina,High Point,113727,288,243,45
North Carolina,Hillsborough,7226,27,25,2
North Carolina,Holden Beach,674,8,8,0
North Carolina,Holly Ridge,3077,11,10,1
North Carolina,Holly Springs,39600,78,63,15
North Carolina,Hope Mills,15924,36,31,5
North Carolina,Hot Springs,579,1,1,0
North Carolina,Hudson,3703,15,14,1
North Carolina,Huntersville,59470,100,92,8
North Carolina,Indian Beach,119,5,5,0
North Carolina,Jackson,448,1,1,0
North Carolina,Jacksonville,71842,149,120,29
North Carolina,Jefferson,1526,6,6,0
North Carolina,Jonesville,2207,9,8,1
North Carolina,Kannapolis,51837,104,78,26
North Carolina,Kenansville,839,3,3,0
North Carolina,Kenly,1612,7,7,0
North Carolina,Kernersville,24835,83,64,19
North Carolina,Kill Devil Hills,7407,35,29,6
North Carolina,King,6860,26,23,3
North Carolina,Kings Mountain,11015,42,33,9
North Carolina,Kinston,19862,82,70,12
North Carolina,Kitty Hawk,3606,18,16,2
North Carolina,Knightdale,18735,33,30,3
North Carolina,Kure Beach,2107,14,13,1
North Carolina,Lake Lure,1152,10,9,1
North Carolina,Lake Royale,2506,12,8,4
North Carolina,Lake Waccamaw,1393,5,5,0
North Carolina,Landis,3144,10,10,0
North Carolina,Laurel Park,2350,8,8,0
North Carolina,Laurinburg,14905,42,40,2
North Carolina,Leland,24967,41,38,3
North Carolina,Lenoir,17880,67,51,16
North Carolina,Lexington,18933,63,53,10
North Carolina,Liberty,2658,10,9,1
North Carolina,Lilesville,479,1,1,0
North Carolina,Lillington,3710,15,14,1
North Carolina,Lincolnton,11300,35,31,4
North Carolina,Littleton,582,3,3,0
North Carolina,Locust,3275,15,15,0
North Carolina,Long View,4936,16,16,0
North Carolina,Louisburg,3641,17,16,1
North Carolina,Lowell,3738,8,8,0
North Carolina,Lumberton,20370,92,83,9
North Carolina,Madison,2103,15,15,0
North Carolina,Maggie Valley,1247,12,11,1
North Carolina,Magnolia,953,2,2,0
North Carolina,Maiden,3456,20,19,1
North Carolina,Manteo,1471,9,8,1
North Carolina,Marion,7861,25,23,2
North Carolina,Marshall,912,4,4,0
North Carolina,Mars Hill,1949,6,6,0
North Carolina,Marshville,2825,9,9,0
North Carolina,Matthews,33860,74,58,16
North Carolina,Maxton,2335,10,6,4
North Carolina,Mayodan,2372,15,15,0
North Carolina,Maysville,925,2,2,0
North Carolina,Mebane,16894,38,34,4
North Carolina,Micro,548,2,2,0
North Carolina,Middlesex,826,5,5,0
North Carolina,Mint Hill,28209,39,36,3
North Carolina,Misenheimer,760,5,5,0
North Carolina,Mocksville,5274,18,17,1
North Carolina,Monroe,35836,100,87,13
North Carolina,Montreat,889,5,5,0
North Carolina,Mooresville,39692,110,82,28
North Carolina,Morehead City,9729,44,41,3
North Carolina,Morganton,16550,90,56,34
North Carolina,Morrisville,30264,41,39,2
North Carolina,Mount Airy,10186,44,33,11
North Carolina,Mount Gilead,1138,7,7,0
North Carolina,Mount Holly,16575,41,32,9
North Carolina,Mount Olive,4573,16,15,1
North Carolina,Murfreesboro,2978,8,7,1
North Carolina,Murphy,1661,11,10,1
North Carolina,Nags Head,2999,25,23,2
North Carolina,Nashville,5549,18,17,1
North Carolina,Navassa,2423,1,1,0
North Carolina,New Bern,30047,111,85,26
North Carolina,Newland,684,5,5,0
North Carolina,Newport,4646,10,10,0
North Carolina,Newton,13204,41,32,9
North Carolina,Newton Grove,564,3,3,0
North Carolina,Norlina,1039,3,3,0
North Carolina,North Topsail Beach,743,14,12,2
North Carolina,Northwest,791,3,3,0
North Carolina,North Wilkesboro,4192,25,24,1
North Carolina,Norwood,2457,9,9,0
North Carolina,Oakboro,1918,8,8,0
North Carolina,Oak Island,8581,26,24,2
North Carolina,Ocean Isle Beach,680,14,13,1
North Carolina,Old Fort,926,4,4,0
North Carolina,Oriental,857,2,2,0
North Carolina,Oxford,8934,31,23,8
North Carolina,Parkton,437,2,2,0
North Carolina,Pembroke,2940,17,14,3
North Carolina,Pikeville,674,4,4,0
North Carolina,Pilot Mountain,1406,9,8,1
North Carolina,Pinebluff,1658,3,3,0
North Carolina,Pinehurst,16837,28,23,5
North Carolina,Pine Knoll Shores,1325,9,9,0
North Carolina,Pine Level,2059,5,5,0
North Carolina,Pinetops,1220,12,7,5
North Carolina,Pineville,9214,50,39,11
North Carolina,Pink Hill,503,1,1,0
North Carolina,Pittsboro,4440,13,12,1
North Carolina,Plymouth,3311,14,13,1
North Carolina,Polkton,2491,2,2,0
North Carolina,Princeton,1423,5,5,0
North Carolina,Raeford,4990,18,16,2
North Carolina,Raleigh,482264,822,695,127
North Carolina,Ramseur,1689,5,5,0
North Carolina,Randleman,4114,15,15,0
North Carolina,Ranlo,3694,12,11,1
North Carolina,Red Springs,3282,16,15,1
North Carolina,Reidsville,13936,52,45,7
North Carolina,Richlands,1726,7,7,0
North Carolina,River Bend,3016,6,6,0
North Carolina,Roanoke Rapids,14178,40,36,4
North Carolina,Robbins,1233,6,6,0
North Carolina,Robersonville,1328,6,6,0
North Carolina,Rockingham,8567,38,36,2
North Carolina,Rockwell,2164,8,8,0
North Carolina,Rocky Mount,53520,183,145,38
North Carolina,Rolesville,9304,21,20,1
North Carolina,Rose Hill,1617,6,6,0
North Carolina,Rowland,987,6,5,1
North Carolina,Roxboro,8304,38,33,5
North Carolina,Rutherfordton,4077,14,14,0
North Carolina,Salisbury,34045,84,76,8
North Carolina,Saluda,695,4,4,0
North Carolina,Sanford,30299,95,72,23
North Carolina,Scotland Neck,1819,9,8,1
North Carolina,Seagrove,229,1,1,0
North Carolina,Selma,7218,21,20,1
North Carolina,Seven Devils,217,6,6,0
North Carolina,Shallotte,4457,16,15,1
North Carolina,Sharpsburg,2012,9,8,1
North Carolina,Shelby,19994,86,73,13
North Carolina,Siler City,8267,22,16,6
North Carolina,Smithfield,13215,40,36,4
North Carolina,Snow Hill,1503,7,7,0
North Carolina,Southern Pines,14924,46,38,8
North Carolina,Southern Shores,2986,13,12,1
North Carolina,Southport,4102,12,12,0
North Carolina,Sparta,1721,6,6,0
North Carolina,Spencer,3256,12,12,0
North Carolina,Spindale,4192,9,9,0
North Carolina,Spring Hope,1309,7,7,0
North Carolina,Spring Lake,12062,31,28,3
North Carolina,Spruce Pine,2133,11,11,0
North Carolina,Stallings,16426,23,21,2
North Carolina,Stanfield,1555,5,5,0
North Carolina,Stanley,3788,12,11,1
North Carolina,Stantonsburg,778,4,4,0
North Carolina,Star,846,4,4,0
North Carolina,Statesville,27879,100,76,24
North Carolina,Stoneville,1252,5,5,0
North Carolina,St. Pauls,2285,19,14,5
North Carolina,Sugar Mountain,197,5,5,0
North Carolina,Sunset Beach,4092,15,15,0
North Carolina,Surf City,2537,23,22,1
North Carolina,Swansboro,3425,13,12,1
North Carolina,Sylva,2757,14,14,0
North Carolina,Tabor City,4181,11,10,1
North Carolina,Tarboro,10629,33,27,6
North Carolina,Taylorsville,2167,12,12,0
North Carolina,Taylortown,867,2,2,0
North Carolina,Thomasville,26631,71,65,6
North Carolina,Topsail Beach,434,9,8,1
North Carolina,Trent Woods,4005,6,6,0
North Carolina,Troutman,2806,15,15,0
North Carolina,Troy,3194,11,10,1
North Carolina,Tryon,1613,9,7,2
North Carolina,Valdese,4416,12,11,1
North Carolina,Vanceboro,961,4,4,0
North Carolina,Vass,799,4,4,0
North Carolina,Wadesboro,5221,29,24,5
North Carolina,Wagram,771,1,1,0
North Carolina,Wake Forest,47738,100,82,18
North Carolina,Wallace,3859,20,16,4
North Carolina,Walnut Creek,862,4,3,1
North Carolina,Warrenton,826,5,4,1
North Carolina,Warsaw,3086,14,12,2
North Carolina,Washington,9459,43,32,11
North Carolina,Waxhaw,18222,31,27,4
North Carolina,Waynesville,10174,46,35,11
North Carolina,Weaverville,4065,17,16,1
North Carolina,Weldon,1452,8,8,0
North Carolina,Wendell,8951,18,16,2
North Carolina,West Jefferson,1313,9,9,0
North Carolina,Whispering Pines,3451,8,7,1
North Carolina,Whitakers,698,2,2,0
North Carolina,White Lake,764,6,6,0
North Carolina,Whiteville,5293,29,26,3
North Carolina,Wilkesboro,3440,24,22,2
North Carolina,Williamston,5145,23,20,3
North Carolina,Wilmington,125794,327,253,74
North Carolina,Wilson,49486,130,114,16
North Carolina,Wilson's Mills,2815,7,7,0
North Carolina,Windsor,3353,9,9,0
North Carolina,Wingate,4741,5,5,0
North Carolina,Winston-Salem,250021,669,498,171
North Carolina,Winterville,10010,20,19,1
North Carolina,Woodfin,6767,15,14,1
North Carolina,Woodland,693,1,1,0
North Carolina,Wrightsville Beach,2563,22,20,2
North Carolina,Yadkinville,2865,14,13,1
North Carolina,Youngsville,1402,11,10,1
North Carolina,Zebulon,6104,21,20,1
North Dakota,Belfield,1039,1,1,0
North Dakota,Berthold,483,1,1,0
North Dakota,Beulah,3141,6,5,1
North Dakota,Bismarck,74997,159,129,30
North Dakota,Bowman,1594,4,3,1
North Dakota,Burlington,1218,2,2,0
North Dakota,Carrington,1971,4,4,0
North Dakota,Cavalier,1226,3,3,0
North Dakota,Devils Lake,7339,21,19,2
North Dakota,Dickinson,23801,61,41,20
North Dakota,Ellendale,1232,2,2,0
North Dakota,Emerado,451,1,1,0
North Dakota,Fargo,126927,204,181,23
North Dakota,Grafton,4143,10,9,1
North Dakota,Grand Forks,56163,106,91,15
North Dakota,Harvey,1630,4,4,0
North Dakota,Hazen,2298,5,5,0
North Dakota,Jamestown,15044,33,29,4
North Dakota,Kenmare,1013,2,2,0
North Dakota,Killdeer,1202,5,5,0
North Dakota,Lamoure,883,1,1,0
North Dakota,Lincoln,4006,6,6,0
North Dakota,Lisbon,2041,4,4,0
North Dakota,Mandan,23221,45,38,7
North Dakota,Medora,131,2,2,0
North Dakota,Minot,48108,110,83,27
North Dakota,Napoleon,747,1,1,0
North Dakota,New Town,2677,5,5,0
North Dakota,Northwood,890,2,2,0
North Dakota,Oakes,1685,3,3,0
North Dakota,Powers Lake,285,2,2,0
North Dakota,Ray,945,1,1,0
North Dakota,Rolette,592,1,1,0
North Dakota,Rolla,1249,4,4,0
North Dakota,Rugby,2561,3,3,0
North Dakota,Stanley,2868,4,4,0
North Dakota,Steele,711,1,1,0
North Dakota,Surrey,1452,2,2,0
North Dakota,Thompson,1025,1,1,0
North Dakota,Tioga,1348,7,5,2
North Dakota,Valley City,6288,17,14,3
North Dakota,Wahpeton,7731,18,16,2
North Dakota,Watford City,9309,27,21,6
North Dakota,West Fargo,38561,78,65,13
North Dakota,Williston,31046,87,74,13
North Dakota,Wishek,880,2,2,0
Ohio,Ada,5500,8,8,0
Ohio,Amherst,12244,31,23,8
Ohio,Andover,1090,3,3,0
Ohio,Archbold,4319,11,11,0
Ohio,Ashland,20247,37,30,7
Ohio,Aurora,16430,37,29,8
Ohio,Bainbridge Township,11442,26,22,4
Ohio,Barberton,25890,42,41,1
Ohio,"Bath Township, Summit County",9635,30,23,7
Ohio,Bay Village,15135,26,22,4
Ohio,Beavercreek,48029,66,50,16
Ohio,Beaver Township,6358,14,10,4
Ohio,Bedford,12383,39,34,5
Ohio,Bellefontaine,13240,37,30,7
Ohio,Bellville,1933,6,6,0
Ohio,Belpre,6381,16,11,5
Ohio,Bethel,2823,6,5,1
Ohio,Bluffton,4054,9,9,0
Ohio,Boardman,38625,79,59,20
Ohio,Bowling Green,31621,52,39,13
Ohio,Brunswick,34948,50,38,12
Ohio,Butler Township,7816,19,18,1
Ohio,Cambridge,10243,29,23,6
Ohio,Canal Fulton,5406,11,10,1
Ohio,Canton,70124,208,167,41
Ohio,Carey,3541,15,12,3
Ohio,Catawba Island Township,3522,5,5,0
Ohio,Celina,10427,21,16,5
Ohio,Centerville,23670,56,41,15
Ohio,Chagrin Falls,3921,14,13,1
Ohio,Cincinnati,304724,1124,1005,119
Ohio,Circleville,14113,29,20,9
Ohio,Clayton,13219,19,18,1
Ohio,Clearcreek Township,16312,17,16,1
Ohio,Cleveland,379121,1788,1546,242
Ohio,Clyde,6141,20,16,4
Ohio,Colerain Township,59307,64,54,10
Ohio,Columbiana,6233,17,14,3
Ohio,Columbus,911383,2277,1897,380
Ohio,Columbus Grove,2071,3,3,0
Ohio,Covington,2720,7,6,1
Ohio,Danville,1012,4,4,0
Ohio,Defiance,16576,32,28,4
Ohio,Delaware,42064,63,55,8
Ohio,Dublin,49954,113,70,43
Ohio,East Cleveland,16859,44,42,2
Ohio,East Liverpool,10539,22,17,5
Ohio,Eaton,8118,16,15,1
Ohio,Elida,1795,3,2,1
Ohio,Elmore,1391,4,4,0
Ohio,Englewood,13435,26,19,7
Ohio,Evendale,2725,22,20,2
Ohio,Fairborn,33951,72,49,23
Ohio,Fairfax,1701,11,10,1
Ohio,Fairfield,42558,80,61,19
Ohio,Fairfield Township,22978,24,22,2
Ohio,Fayette,1237,5,5,0
Ohio,Findlay,41237,82,64,18
Ohio,Forest Park,18571,43,36,7
Ohio,Fort Loramie,1527,2,2,0
Ohio,Fort Recovery,1458,3,3,0
Ohio,Genoa Township,28758,28,26,2
Ohio,Germantown,5517,12,11,1
Ohio,"German Township, Montgomery County",2894,6,6,0
Ohio,Greenhills,3563,11,10,1
Ohio,Green Springs,1300,2,2,0
Ohio,Greenville,12549,30,23,7
Ohio,Groveport,5649,25,24,1
Ohio,Harrison,12133,24,21,3
Ohio,Heath,11015,27,19,8
Ohio,Hilliard,37585,75,63,12
Ohio,Hinckley Township,8117,14,13,1
Ohio,Hiram,1135,3,3,0
Ohio,Holland,1650,9,9,0
Ohio,Howland Township,16318,19,19,0
Ohio,Hubbard,7370,13,13,0
Ohio,Huber Heights,38158,72,52,20
Ohio,Hudson,22234,35,29,6
Ohio,Hunting Valley,716,11,11,0
Ohio,Ironton,10469,16,15,1
Ohio,"Jackson Township, Mahoning County",1999,7,7,0
Ohio,Jamestown,2148,5,5,0
Ohio,Kent,29732,59,42,17
Ohio,Kirtland Hills,644,8,7,1
Ohio,Lancaster,40700,78,62,16
Ohio,Lockland,3440,14,14,0
Ohio,Lordstown,3241,13,9,4
Ohio,Loudonville,2614,7,7,0
Ohio,Louisville,9370,13,13,0
Ohio,Lyndhurst,13291,35,28,7
Ohio,Macedonia,12098,33,24,9
Ohio,Madeira,9303,15,14,1
Ohio,"Madison Township, Franklin County",19828,17,16,1
Ohio,Mansfield,46476,115,79,36
Ohio,Mariemont,3524,10,10,0
Ohio,Maumee,13605,50,38,12
Ohio,Medina,25882,50,39,11
Ohio,Medina Township,9105,10,10,0
Ohio,Mentor-on-the-Lake,7385,14,9,5
Ohio,Miamisburg,20140,37,35,2
Ohio,"Miami Township, Clermont County",42931,45,42,3
Ohio,Middletown,48814,127,88,39
Ohio,Mifflin Township,2609,6,6,0
Ohio,Milan,1330,3,3,0
Ohio,Milford,6872,21,19,2
Ohio,Milton Township,2415,5,5,0
Ohio,Minerva Park,1326,10,9,1
Ohio,Minster,2818,8,7,1
Ohio,Mogadore,3816,8,8,0
Ohio,Monroeville,1345,5,5,0
Ohio,Montgomery,10929,25,22,3
Ohio,Napoleon,8148,22,17,5
Ohio,Navarre,1804,6,6,0
Ohio,Newark,50625,86,76,10
Ohio,New Boston,2080,12,8,4
Ohio,New Bremen,2959,7,7,0
Ohio,Newcomerstown,3728,9,6,3
Ohio,New London,2347,5,5,0
Ohio,Newtown,2671,9,8,1
Ohio,Niles,18070,40,35,5
Ohio,North Olmsted,31176,59,46,13
Ohio,North Randall,983,10,10,0
Ohio,North Ridgeville,34972,46,40,6
Ohio,Northwood,5458,23,18,5
Ohio,Norton,11951,17,16,1
Ohio,Norwalk,16843,32,25,7
Ohio,Oberlin,8178,23,17,6
Ohio,Orrville,8427,17,16,1
Ohio,Ottawa,4346,8,8,0
Ohio,Ottoville,962,2,2,0
Ohio,Oxford Township,2210,3,3,0
Ohio,Peninsula,554,3,3,0
Ohio,Perkins Township,11636,21,20,1
Ohio,Perrysburg Township,13011,31,24,7
Ohio,"Perry Township, Columbiana County",4259,4,4,0
Ohio,"Perry Township, Franklin County",3761,12,11,1
Ohio,"Perry Township, Stark County",28005,27,24,3
Ohio,Pierce Township,11789,19,18,1
Ohio,Plain City,4628,12,11,1
Ohio,Poland Township,11772,12,12,0
Ohio,Port Clinton,6159,21,16,5
Ohio,Portsmouth,20151,52,41,11
Ohio,Powell,13593,22,20,2
Ohio,Reynoldsburg,38600,84,67,17
Ohio,Rockford,1102,2,2,0
Ohio,Rocky River,19951,38,34,4
Ohio,Rossford,6587,17,16,1
Ohio,Russell Township,5199,11,10,1
Ohio,Salem,11538,23,23,0
Ohio,Salineville,1209,2,2,0
Ohio,Seaman,891,2,2,0
Ohio,Sebring,4163,12,7,5
Ohio,Seven Hills,11561,18,17,1
Ohio,Shaker Heights,26859,79,64,15
Ohio,Sharonville,13712,51,40,11
Ohio,Shawnee Hills,837,4,4,0
Ohio,Shawnee Township,12044,18,13,5
Ohio,Sidney,20372,47,36,11
Ohio,Silver Lake,2491,9,8,1
Ohio,South Russell,3736,9,9,0
Ohio,Spencerville,2154,4,4,0
Ohio,Springboro,19109,35,31,4
Ohio,Springfield,58696,134,124,10
Ohio,"Springfield Township, Hamilton County",35947,51,45,6
Ohio,"Springfield Township, Mahoning County",6352,10,10,0
Ohio,St. Henry,2568,3,3,0
Ohio,St. Marys,8142,21,16,5
Ohio,Stow,34781,51,42,9
Ohio,Strasburg,2697,5,5,0
Ohio,Strongsville,44623,87,68,19
Ohio,Sugarcreek,2236,9,9,0
Ohio,Sugarcreek Township,8484,19,17,2
Ohio,Sylvania,19337,38,31,7
Ohio,Sylvania Township,29711,62,44,18
Ohio,Tallmadge,17517,30,26,4
Ohio,Tiffin,17543,38,28,10
Ohio,Toledo,271237,682,609,73
Ohio,Trenton,13281,22,17,5
Ohio,Troy,26407,45,42,3
Ohio,Uhrichsville,5304,9,9,0
Ohio,"Union Township, Clermont County",48733,63,49,14
Ohio,University Heights,12711,32,29,3
Ohio,Upper Sandusky,6423,17,13,4
Ohio,Urbana,11351,18,18,0
Ohio,"Valley View, Cuyahoga County",1992,20,18,2
Ohio,Vandalia,14968,39,30,9
Ohio,Van Wert,10659,28,20,8
Ohio,Wadsworth,24324,40,31,9
Ohio,Warren,38462,72,67,5
Ohio,Wells Township,2624,5,5,0
Ohio,West Carrollton,12833,22,20,2
Ohio,West Salem,1513,1,1,0
Ohio,West Union,3152,5,4,1
Ohio,Whitehall,19014,63,49,14
Ohio,Whitehouse,4932,11,11,0
Ohio,Wickliffe,12743,39,29,10
Ohio,Williamsburg,2579,6,6,0
Ohio,Willoughby,23058,56,42,14
Ohio,Wooster,26424,47,43,4
Ohio,Worthington,14822,37,33,4
Ohio,Xenia,27095,69,44,25
Ohio,Zanesville,25136,96,57,39
Oklahoma,Achille,545,3,2,1
Oklahoma,Ada,17278,37,34,3
Oklahoma,Adair,809,4,4,0
Oklahoma,Allen,925,4,3,1
Oklahoma,Altus,18184,51,39,12
Oklahoma,Alva,4944,10,10,0
Oklahoma,Amber,487,2,2,0
Oklahoma,Anadarko,6473,19,18,1
Oklahoma,Antlers,2308,16,6,10
Oklahoma,Apache,1387,3,3,0
Oklahoma,Arcadia,273,1,1,0
Oklahoma,Ardmore,24718,63,44,19
Oklahoma,Arkoma,1889,4,2,2
Oklahoma,Atoka,3019,17,16,1
Oklahoma,Barnsdall,1140,4,4,0
Oklahoma,Bartlesville,36183,82,62,20
Oklahoma,Beaver,1387,1,1,0
Oklahoma,Beggs,1233,5,3,2
Oklahoma,Bennington,370,2,2,0
Oklahoma,Bernice,581,1,1,0
Oklahoma,Bethany,19239,35,26,9
Oklahoma,Big Cabin,248,1,1,0
Oklahoma,Binger,628,1,1,0
Oklahoma,Bixby,28840,43,32,11
Oklahoma,Blackwell,6508,22,14,8
Oklahoma,Blanchard,9090,15,10,5
Oklahoma,Boise City,1067,2,2,0
Oklahoma,Bokchito,694,6,5,1
Oklahoma,Bokoshe,496,3,2,1
Oklahoma,Boley,1173,2,2,0
Oklahoma,Boswell,679,3,3,0
Oklahoma,Bristow,4196,15,11,4
Oklahoma,Broken Arrow,111488,201,148,53
Oklahoma,Broken Bow,4081,18,12,6
Oklahoma,Burns Flat,1885,4,4,0
Oklahoma,Cache,2810,4,3,1
Oklahoma,Caddo,1115,4,4,0
Oklahoma,Calera,2393,11,10,1
Oklahoma,Calvin,273,2,1,1
Oklahoma,Caney,197,4,3,1
Oklahoma,Canton,585,3,3,0
Oklahoma,Carnegie,1636,8,4,4
Oklahoma,Carney,620,2,2,0
Oklahoma,Cashion,879,2,2,0
Oklahoma,Catoosa,6930,18,16,2
Oklahoma,Cement,472,1,1,0
Oklahoma,Chandler,3084,11,8,3
Oklahoma,Chattanooga,451,2,1,1
Oklahoma,Checotah,3069,13,10,3
Oklahoma,Chelsea,1899,4,4,0
Oklahoma,Cherokee,1489,3,3,0
Oklahoma,Chickasha,16478,37,28,9
Oklahoma,Choctaw,12850,21,17,4
Oklahoma,Chouteau,2090,10,9,1
Oklahoma,Claremore,18757,45,38,7
Oklahoma,Clayton,782,8,4,4
Oklahoma,Cleveland,3112,8,8,0
Oklahoma,Clinton,9094,26,17,9
Oklahoma,Coalgate,1774,6,6,0
Oklahoma,Colbert,1264,3,2,1
Oklahoma,Colcord,852,6,5,1
Oklahoma,Collinsville,7441,20,11,9
Oklahoma,Comanche,1547,6,6,0
Oklahoma,Commerce,2502,5,5,0
Oklahoma,Cordell,2715,5,4,1
Oklahoma,Covington,534,1,1,0
Oklahoma,Coweta,10109,23,15,8
Oklahoma,Crescent,1577,7,5,2
Oklahoma,Cushing,7592,24,16,8
Oklahoma,Cyril,1006,2,2,0
Oklahoma,Davenport,806,2,2,0
Oklahoma,Davis,2921,10,8,2
Oklahoma,Del City,21750,51,38,13
Oklahoma,Depew,479,2,2,0
Oklahoma,Dewar,848,3,3,0
Oklahoma,Dewey,3381,12,10,2
Oklahoma,Dibble,868,4,3,1
Oklahoma,Dickson,1252,4,3,1
Oklahoma,Disney,302,1,1,0
Oklahoma,Drumright,2827,6,6,0
Oklahoma,Duncan,22226,67,48,19
Oklahoma,Durant,19007,41,36,5
Oklahoma,Earlsboro,623,3,2,1
Oklahoma,Edmond,95571,154,117,37
Oklahoma,Eldorado,402,1,1,0
Oklahoma,Elgin,3313,5,5,0
Oklahoma,Elk City,11571,35,26,9
Oklahoma,Elmore City,712,5,4,1
Oklahoma,El Reno,20348,49,34,15
Oklahoma,Enid,49708,113,85,28
Oklahoma,Erick,993,1,1,0
Oklahoma,Eufaula,2849,11,10,1
Oklahoma,Fairfax,1253,3,1,2
Oklahoma,Fairland,1028,3,2,1
Oklahoma,Fairview,2596,9,5,4
Oklahoma,Fletcher,1138,2,2,0
Oklahoma,Forest Park,1077,4,2,2
Oklahoma,Fort Gibson,3936,15,14,1
Oklahoma,Fort Towson,487,2,2,0
Oklahoma,Frederick,3504,8,6,2
Oklahoma,Gans,299,1,1,0
Oklahoma,Garber,805,1,1,0
Oklahoma,Geary,1263,12,6,6
Oklahoma,Geronimo,1208,1,1,0
Oklahoma,Glenpool,14319,32,24,8
Oklahoma,Goodwell,1267,4,4,0
Oklahoma,Gore,948,5,4,1
Oklahoma,Grandfield,922,1,1,0
Oklahoma,Granite,1946,4,4,0
Oklahoma,Grove,7210,30,21,9
Oklahoma,Guthrie,11829,38,26,12
Oklahoma,Guymon,10939,22,17,5
Oklahoma,Haileyville,745,3,3,0
Oklahoma,Harrah,6681,11,10,1
Oklahoma,Hartshorne,1944,4,3,1
Oklahoma,Haskell,1922,8,8,0
Oklahoma,Healdton,2671,4,4,0
Oklahoma,Heavener,3286,9,8,1
Oklahoma,Hennessey,2233,9,5,4
Oklahoma,Henryetta,5527,15,11,4
Oklahoma,Hinton,3221,6,6,0
Oklahoma,Hobart,3393,12,7,5
Oklahoma,Holdenville,5470,11,10,1
Oklahoma,Hollis,1853,9,5,4
Oklahoma,Hominy,3370,8,4,4
Oklahoma,Hooker,1835,2,2,0
Oklahoma,Howe,787,2,2,0
Oklahoma,Hugo,5067,25,16,9
Oklahoma,Hulbert,581,4,3,1
Oklahoma,Hydro,933,3,3,0
Oklahoma,Idabel,6827,25,20,5
Oklahoma,Inola,1804,6,5,1
Oklahoma,Jay,2546,14,9,5
Oklahoma,Jenks,24639,35,24,11
Oklahoma,Jennings,353,1,1,0
Oklahoma,Jones,3225,6,6,0
Oklahoma,Kansas,801,5,5,0
Oklahoma,Kellyville,1146,2,2,0
Oklahoma,Keota,547,2,2,0
Oklahoma,Kiefer,2053,5,5,0
Oklahoma,Kingfisher,4939,14,14,0
Oklahoma,Kingston,1683,7,7,0
Oklahoma,Kiowa,670,8,6,2
Oklahoma,Konawa,1186,5,5,0
Oklahoma,Krebs,1933,9,7,2
Oklahoma,Lahoma,617,1,1,0
Oklahoma,Langley,821,4,4,0
Oklahoma,Langston,1872,3,2,1
Oklahoma,Laverne,1327,1,1,0
Oklahoma,Lawton,92507,208,170,38
Oklahoma,Lexington,2188,9,5,4
Oklahoma,Lindsay,2770,16,9,7
Oklahoma,Locust Grove,1392,9,8,1
Oklahoma,Lone Grove,5153,11,7,4
Oklahoma,Luther,1829,7,6,1
Oklahoma,Madill,4063,12,11,1
Oklahoma,Mangum,2667,11,6,5
Oklahoma,Mannford,3207,11,7,4
Oklahoma,Marietta,2785,8,8,0
Oklahoma,Marlow,4393,14,9,5
Oklahoma,Maud,1061,3,3,0
Oklahoma,Maysville,1202,6,5,1
Oklahoma,McAlester,17752,41,39,2
Oklahoma,McCurtain,500,4,3,1
Oklahoma,McLoud,4767,11,10,1
Oklahoma,Medford,932,3,3,0
Oklahoma,Medicine Park,460,2,2,0
Oklahoma,Meeker,1140,5,5,0
Oklahoma,Miami,13032,33,32,1
Oklahoma,Midwest City,57730,125,99,26
Oklahoma,Minco,1650,5,5,0
Oklahoma,Moore,62840,95,90,5
Oklahoma,Mooreland,1165,4,3,1
Oklahoma,Morris,1414,3,3,0
Oklahoma,Mounds,1273,1,1,0
Oklahoma,Mountain View,729,2,2,0
Oklahoma,Muldrow,3228,13,8,5
Oklahoma,Muskogee,36884,92,84,8
Oklahoma,Mustang,23658,37,26,11
Oklahoma,Newcastle,11038,30,22,8
Oklahoma,Newkirk,2155,6,6,0
Oklahoma,Nichols Hills,3966,24,16,8
Oklahoma,Nicoma Park,2473,6,5,1
Oklahoma,Ninnekah,1052,4,3,1
Oklahoma,Noble,7117,18,13,5
Oklahoma,Norman,126480,230,164,66
Oklahoma,North Enid,928,3,3,0
Oklahoma,Nowata,3533,8,6,2
Oklahoma,Oilton,1014,3,3,0
Oklahoma,Okarche,1344,6,5,1
Oklahoma,Okeene,1131,2,2,0
Oklahoma,Okemah,3120,14,9,5
Oklahoma,Oklahoma City,663661,1443,1161,282
Oklahoma,Okmulgee,11627,21,18,3
Oklahoma,Olustee,549,1,1,0
Oklahoma,Oologah,1179,5,5,0
Oklahoma,Owasso,37815,84,62,22
Oklahoma,Paoli,613,2,2,0
Oklahoma,Pauls Valley,6111,18,14,4
Oklahoma,Pawhuska,3386,17,9,8
Oklahoma,Pawnee,2096,5,5,0
Oklahoma,Perkins,2815,8,8,0
Oklahoma,Perry,4807,18,12,6
Oklahoma,Piedmont,8931,12,10,2
Oklahoma,Pocola,4128,12,8,4
Oklahoma,Ponca City,23484,65,46,19
Oklahoma,Pond Creek,831,2,2,0
Oklahoma,Porum,698,4,4,0
Oklahoma,Poteau,8899,35,27,8
Oklahoma,Prague,2365,14,9,5
Oklahoma,Pryor Creek,9361,38,29,9
Oklahoma,Purcell,6445,23,20,3
Oklahoma,Quinton,978,4,4,0
Oklahoma,Ramona,546,5,4,1
Oklahoma,Rattan,295,2,2,0
Oklahoma,Ringling,946,1,1,0
Oklahoma,Roland,3998,11,8,3
Oklahoma,Rush Springs,1259,5,5,0
Oklahoma,Salina,1393,7,6,1
Oklahoma,Sallisaw,8448,30,22,8
Oklahoma,Sand Springs,20026,44,31,13
Oklahoma,Sapulpa,21394,53,43,10
Oklahoma,Savanna,641,8,6,2
Oklahoma,Sawyer,312,3,2,1
Oklahoma,Sayre,4500,12,6,6
Oklahoma,Seiling,855,1,1,0
Oklahoma,Seminole,6994,12,11,1
Oklahoma,Shady Point,996,1,1,0
Oklahoma,Shattuck,1247,1,1,0
Oklahoma,Shawnee,31606,89,72,17
Oklahoma,Skiatook,8135,23,19,4
Oklahoma,Snyder,1265,3,3,0
Oklahoma,South Coffeyville,729,5,5,0
Oklahoma,Spavinaw,428,1,1,0
Oklahoma,Spencer,3973,5,3,2
Oklahoma,Sperry,1354,4,4,0
Oklahoma,Spiro,2157,4,4,0
Oklahoma,Sportsmen Acres,307,1,1,0
Oklahoma,Stigler,2680,14,9,5
Oklahoma,Stillwater,50831,118,74,44
Oklahoma,Stilwell,4070,18,12,6
Oklahoma,Stratford,1525,4,4,0
Oklahoma,Stringtown,401,5,5,0
Oklahoma,Stroud,2701,11,7,4
Oklahoma,Sulphur,5055,12,10,2
Oklahoma,Tahlequah,16936,46,40,6
Oklahoma,Talala,279,1,1,0
Oklahoma,Talihina,1078,8,5,3
Oklahoma,Tecumseh,6652,13,10,3
Oklahoma,Texhoma,898,2,2,0
Oklahoma,Thackerville,520,2,1,1
Oklahoma,The Village,9632,29,23,6
Oklahoma,Thomas,1200,1,1,0
Oklahoma,Tipton,750,1,1,0
Oklahoma,Tishomingo,3085,9,7,2
Oklahoma,Tonkawa,2956,13,8,5
Oklahoma,Tryon,502,2,1,1
Oklahoma,Tulsa,402166,1034,819,215
Oklahoma,Tupelo,300,3,3,0
Oklahoma,Tushka,388,3,3,0
Oklahoma,Tuttle,7768,19,13,6
Oklahoma,Tyrone,738,2,1,1
Oklahoma,Union City,2221,8,7,1
Oklahoma,Valley Brook,770,7,7,0
Oklahoma,Valliant,736,4,4,0
Oklahoma,Velma,592,2,2,0
Oklahoma,Verden,538,4,2,2
Oklahoma,Verdigris,4669,7,6,1
Oklahoma,Vian,1356,6,6,0
Oklahoma,Vici,705,1,1,0
Oklahoma,Vinita,5264,21,15,6
Oklahoma,Wagoner,9283,21,16,5
Oklahoma,Walters,2334,5,5,0
Oklahoma,Warner,1584,4,4,0
Oklahoma,Warr Acres,10140,30,25,5
Oklahoma,Washington,605,4,2,2
Oklahoma,Watonga,2820,10,7,3
Oklahoma,Watts,312,3,2,1
Oklahoma,Waukomis,1297,2,2,0
Oklahoma,Waynoka,912,4,4,0
Oklahoma,Weatherford,12155,40,25,15
Oklahoma,Webbers Falls,590,4,4,0
Oklahoma,Weleetka,949,9,6,3
Oklahoma,Wellston,772,3,3,0
Oklahoma,West Siloam Springs,862,12,11,1
Oklahoma,Westville,1542,9,5,4
Oklahoma,Wetumka,1193,12,6,6
Oklahoma,Wewoka,3202,5,5,0
Oklahoma,Wilburton,2512,7,6,1
Oklahoma,Wilson,1692,4,4,0
Oklahoma,Wister,1058,3,3,0
Oklahoma,Woodward,12143,23,19,4
Oklahoma,Wright City,732,3,2,1
Oklahoma,Wyandotte,323,11,9,2
Oklahoma,Wynnewood,2201,6,5,1
Oklahoma,Yale,1222,7,4,3
Oklahoma,Yukon,28735,69,52,17
Oregon,Albany,55926,89,56,33
Oregon,Ashland,21419,36,29,7
Oregon,Astoria,10076,27,16,11
Oregon,Aumsville,4249,8,7,1
Oregon,Baker City,9808,16,15,1
Oregon,Bandon,3161,9,6,3
Oregon,Beaverton,100085,176,131,45
Oregon,Bend,103485,131,97,34
Oregon,Black Butte,,8,7,1
Oregon,Boardman,3811,13,12,1
Oregon,Brookings,6495,23,15,8
Oregon,Burns,2794,4,4,0
Oregon,Canby,18074,30,26,4
Oregon,Cannon Beach,1777,10,7,3
Oregon,Carlton,2202,4,4,0
Oregon,Central Point,19032,33,27,6
Oregon,Coburg,1187,5,4,1
Oregon,Columbia City,2030,2,2,0
Oregon,Coos Bay,16403,36,24,12
Oregon,Coquille,3944,7,6,1
Oregon,Corvallis,59375,109,73,36
Oregon,Cottage Grove,10556,32,17,15
Oregon,Dallas,17265,15,10,5
Oregon,Eagle Point,9681,12,11,1
Oregon,Enterprise,2002,4,4,0
Oregon,Eugene,174513,317,197,120
Oregon,Florence,9228,23,16,7
Oregon,Forest Grove,26065,35,30,5
Oregon,Gearhart,1662,3,3,0
Oregon,Gervais,2795,6,5,1
Oregon,Gladstone,12418,18,15,3
Oregon,Gold Beach,2310,8,6,2
Oregon,Grants Pass,38420,92,57,35
Oregon,Gresham,109767,155,127,28
Oregon,Hermiston,17896,33,28,5
Oregon,Hillsboro,111146,185,135,50
Oregon,Hines,1543,4,4,0
Oregon,Hood River,7863,14,13,1
Oregon,Hubbard,3615,7,6,1
Oregon,Independence,10477,20,15,5
Oregon,Jacksonville,2912,6,5,1
Oregon,John Day,1663,5,4,1
Oregon,Junction City,6333,16,10,6
Oregon,Keizer,40087,47,40,7
Oregon,King City,4512,7,6,1
Oregon,Klamath Falls,22693,38,34,4
Oregon,La Grande,13674,30,18,12
Oregon,Lake Oswego,40171,67,41,26
Oregon,Lebanon,17635,40,27,13
Oregon,Lincoln City,9275,38,24,14
Oregon,Madras,7140,11,10,1
Oregon,Malin,835,7,7,0
Oregon,Manzanita,668,4,4,0
Oregon,McMinnville,35040,48,42,6
Oregon,Medford,84016,165,114,51
Oregon,Milton-Freewater,7075,16,11,5
Oregon,Milwaukie,21040,42,37,5
Oregon,Molalla,9351,18,16,2
Oregon,Monmouth,10708,15,14,1
Oregon,Mount Angel,3647,8,6,2
Oregon,Myrtle Creek,3493,9,7,2
Oregon,Myrtle Point,2564,6,5,1
Oregon,Newberg-Dundee,24081,47,33,14
Oregon,Newport,10950,28,21,7
Oregon,North Bend,9778,24,17,7
Oregon,Nyssa,3176,7,7,0
Oregon,Oakridge,3389,6,5,1
Oregon,Ontario,10952,29,24,5
Oregon,Oregon City,37892,52,44,8
Oregon,Pendleton,16804,27,23,4
Oregon,Philomath,5805,10,9,1
Oregon,Phoenix,4680,11,9,2
Oregon,Pilot Rock,1510,2,2,0
Oregon,Portland,662941,1132,873,259
Oregon,Port Orford,1155,5,5,0
Oregon,Prineville,10919,31,21,10
Oregon,Rainier,2021,6,5,1
Oregon,Redmond,33198,54,43,11
Oregon,Reedsport,4111,15,10,5
Oregon,Rockaway Beach,1429,3,3,0
Oregon,Rogue River,2355,8,6,2
Oregon,Roseburg,23551,43,38,5
Oregon,Salem,176632,336,189,147
Oregon,Sandy,11598,19,15,4
Oregon,Scappoose,7666,11,10,1
Oregon,Seaside,6938,27,19,8
Oregon,Sherwood,20052,28,24,4
Oregon,Silverton,10782,19,16,3
Oregon,Springfield,63666,93,60,33
Oregon,Stanfield,2119,4,4,0
Oregon,Stayton,8364,13,12,1
Oregon,St. Helens,13818,22,19,3
Oregon,Sunriver,1393,13,12,1
Oregon,Sutherlin,8223,18,14,4
Oregon,Sweet Home,10099,21,14,7
Oregon,Talent,6671,9,7,2
Oregon,The Dalles,15849,28,25,3
Oregon,Tigard,56377,83,67,16
Oregon,Tillamook,5392,11,8,3
Oregon,Toledo,3665,13,7,6
Oregon,Tualatin,28030,47,40,7
Oregon,Turner,2153,2,2,0
Oregon,Umatilla,7366,15,13,2
Oregon,Vernonia,2294,6,5,1
Oregon,Warrenton,5823,14,12,2
Oregon,West Linn,26916,34,30,4
Oregon,Winston,5528,12,10,2
Oregon,Woodburn,26521,41,32,9
Oregon,Yamhill,1187,6,3,3
Pennsylvania,"Abington Township, Montgomery County",55310,108,90,18
Pennsylvania,"Adams Township, Butler County",14255,17,17,0
Pennsylvania,"Adams Township, Cambria County",5474,5,5,0
Pennsylvania,Akron,4029,3,3,0
Pennsylvania,Alburtis,2669,4,4,0
Pennsylvania,Aldan,4160,7,5,2
Pennsylvania,Aliquippa,8780,15,14,1
Pennsylvania,"Allegheny Township, Blair County",6490,10,9,1
Pennsylvania,"Allegheny Township, Westmoreland County",7993,11,10,1
Pennsylvania,Allegheny Valley Regional,3241,2,2,0
Pennsylvania,Allentown,121818,234,214,20
Pennsylvania,Altoona,43090,71,63,8
Pennsylvania,Ambler,6498,14,13,1
Pennsylvania,Ambridge,6553,10,10,0
Pennsylvania,Amity Township,13237,15,14,1
Pennsylvania,Annville Township,5087,6,5,1
Pennsylvania,Apollo,1510,1,1,0
Pennsylvania,Archbald,7033,7,7,0
Pennsylvania,Ashland,2664,2,2,0
Pennsylvania,Ashley,2715,3,3,0
Pennsylvania,Aspinwall,2682,5,5,0
Pennsylvania,Aston Township,16753,22,20,2
Pennsylvania,Athens,3170,4,4,0
Pennsylvania,Athens Township,5053,11,10,1
Pennsylvania,Avalon,4518,5,5,0
Pennsylvania,Avoca,2625,3,3,0
Pennsylvania,Avonmore Boro,945,2,1,1
Pennsylvania,Baden,3853,3,3,0
Pennsylvania,Baldwin Borough,19508,25,24,1
Pennsylvania,Baldwin Township,1931,5,5,0
Pennsylvania,Bally,1267,2,2,0
Pennsylvania,Bangor,5224,7,7,0
Pennsylvania,Beaver,4238,11,10,1
Pennsylvania,Beaver Falls,9418,17,16,1
Pennsylvania,Beaver Meadows,831,2,1,1
Pennsylvania,Bedford,2660,5,5,0
Pennsylvania,Bedminster Township,7300,8,7,1
Pennsylvania,Bell Acres,1365,5,5,0
Pennsylvania,Bellefonte,6247,11,10,1
Pennsylvania,Bellevue,8002,14,13,1
Pennsylvania,Bellwood,1741,3,3,0
Pennsylvania,Bensalem Township,60517,129,102,27
Pennsylvania,Bentleyville,2469,1,1,0
Pennsylvania,Berlin,1925,2,2,0
Pennsylvania,Bern Township,6984,12,12,0
Pennsylvania,Bernville,945,1,1,0
Pennsylvania,Berwick,9839,17,16,1
Pennsylvania,Bethel Park,32350,45,37,8
Pennsylvania,"Bethel Township, Berks County",4176,6,5,1
Pennsylvania,Bethlehem,75909,167,153,14
Pennsylvania,Bethlehem Township,24403,36,35,1
Pennsylvania,Bigler Township Regional,1224,1,1,0
Pennsylvania,Biglerville,1221,2,2,0
Pennsylvania,Birdsboro,5145,8,7,1
Pennsylvania,Birmingham Township,4200,3,3,0
Pennsylvania,Blairsville,3196,5,5,0
Pennsylvania,Blair Township,4475,5,5,0
Pennsylvania,Blakely,6173,9,9,0
Pennsylvania,Blawnox,1382,3,3,0
Pennsylvania,Bloomsburg Town,13700,22,17,5
Pennsylvania,Bonneauville,1841,1,1,0
Pennsylvania,Brackenridge,3122,4,4,0
Pennsylvania,Bradford,8150,19,19,0
Pennsylvania,Bradford Township,4560,5,5,0
Pennsylvania,Branch Township,1730,2,2,0
Pennsylvania,"Brecknock Township, Berks County",4701,5,5,0
Pennsylvania,Brentwood,9228,16,14,2
Pennsylvania,Briar Creek Township,2926,5,5,0
Pennsylvania,Bridgeport,4571,9,8,1
Pennsylvania,Bridgeville,4883,9,8,1
Pennsylvania,Bridgewater,840,4,3,1
Pennsylvania,Brighton Township,8270,12,12,0
Pennsylvania,Bristol,9560,15,13,2
Pennsylvania,Bristol Township,53355,61,54,7
Pennsylvania,Brookhaven,8052,8,7,1
Pennsylvania,Brownsville,2211,3,3,0
Pennsylvania,Bryn Athyn,1408,4,4,0
Pennsylvania,Buckingham Township,20255,22,20,2
Pennsylvania,Buffalo Township,7407,8,8,0
Pennsylvania,Buffalo Valley Regional,12699,16,15,1
Pennsylvania,Bushkill Township,8655,16,15,1
Pennsylvania,Butler,12792,25,24,1
Pennsylvania,"Butler Township, Butler County",16384,23,21,2
Pennsylvania,"Butler Township, Luzerne County",10023,11,10,1
Pennsylvania,"Butler Township, Schuylkill County",5539,5,5,0
Pennsylvania,"Caernarvon Township, Berks County",4191,8,7,1
Pennsylvania,California,6653,9,8,1
Pennsylvania,Caln Township,14323,19,18,1
Pennsylvania,Cambria Township,5651,3,3,0
Pennsylvania,Cambridge Springs,2677,3,3,0
Pennsylvania,Camp Hill,7906,14,13,1
Pennsylvania,Canonsburg,8734,18,17,1
Pennsylvania,Canton,1850,3,3,0
Pennsylvania,Carbondale,8329,9,9,0
Pennsylvania,Carlisle,19249,34,32,2
Pennsylvania,Carmichaels,438,1,1,0
Pennsylvania,Carnegie,7787,14,13,1
Pennsylvania,Carrolltown,777,2,2,0
Pennsylvania,"Carroll Township, Washington County",5420,3,3,0
Pennsylvania,"Carroll Township, York County",6583,13,13,0
Pennsylvania,Carroll Valley,3949,3,2,1
Pennsylvania,Castle Shannon,8205,14,13,1
Pennsylvania,Catasauqua,6617,10,9,1
Pennsylvania,Catawissa,1457,5,5,0
Pennsylvania,Cecil Township,13262,26,25,1
Pennsylvania,Center Township,11423,19,18,1
Pennsylvania,Centerville,3125,3,3,0
Pennsylvania,Central Berks Regional,13624,21,20,1
Pennsylvania,Central Bucks Regional,15526,30,26,4
Pennsylvania,Chambersburg,21247,34,31,3
Pennsylvania,Charleroi Regional,6418,11,11,0
Pennsylvania,Chartiers Township,8134,14,14,0
Pennsylvania,Cheltenham Township,37159,81,74,7
Pennsylvania,Chester,34007,83,81,2
Pennsylvania,Chester Township,4086,12,12,0
Pennsylvania,Chippewa Township,7901,9,8,1
Pennsylvania,Churchill,2909,7,7,0
Pennsylvania,Clairton,6513,14,14,0
Pennsylvania,Clarion,5766,9,8,1
Pennsylvania,Clarks Summit,6218,5,5,0
Pennsylvania,Clearfield,5801,7,7,0
Pennsylvania,Cleona,2235,4,4,0
Pennsylvania,Clifton Heights,6702,12,11,1
Pennsylvania,Clymer,1256,2,2,0
Pennsylvania,Coaldale,2125,4,4,0
Pennsylvania,Coal Township,10192,12,11,1
Pennsylvania,Coatesville,13068,31,27,4
Pennsylvania,Cochranton,1070,2,2,0
Pennsylvania,Collegeville,5183,8,8,0
Pennsylvania,Collier Township,8348,19,18,1
Pennsylvania,Collingdale,8795,11,10,1
Pennsylvania,Colonial Regional,18309,27,25,2
Pennsylvania,Columbia,10351,22,19,3
Pennsylvania,"Conemaugh Township, Cambria County",1806,1,1,0
Pennsylvania,"Conemaugh Township, Somerset County",6799,6,6,0
Pennsylvania,"Conewago Township, Adams County",7243,11,10,1
Pennsylvania,Conewango Township,3312,4,4,0
Pennsylvania,Conneaut Lake Regional,4745,4,4,0
Pennsylvania,Connellsville,7247,15,15,0
Pennsylvania,Conshohocken,8069,21,19,2
Pennsylvania,Conway,2055,5,5,0
Pennsylvania,Conyngham,1862,3,3,0
Pennsylvania,Coopersburg,2588,7,7,0
Pennsylvania,Coplay,3222,6,5,1
Pennsylvania,Coraopolis,5400,14,10,4
Pennsylvania,Cornwall,4406,7,6,1
Pennsylvania,Corry,6165,10,9,1
Pennsylvania,Coudersport,2389,3,3,0
Pennsylvania,Courtdale,715,9,9,0
Pennsylvania,Covington Township,2271,3,3,0
Pennsylvania,Crafton,6157,10,9,1
Pennsylvania,Cranberry Township,32051,34,31,3
Pennsylvania,Crescent Township,2539,6,6,0
Pennsylvania,Cresson,1537,2,2,0
Pennsylvania,Cresson Township,2487,1,1,0
Pennsylvania,Croyle Township,2202,1,1,0
Pennsylvania,"Cumberland Township, Adams County",6267,12,12,0
Pennsylvania,"Cumberland Township, Greene County",6108,6,6,0
Pennsylvania,Cumru Township,15512,27,26,1
Pennsylvania,Curwensville,2369,4,3,1
Pennsylvania,Dallas,2787,6,6,0
Pennsylvania,Dallas Township,9304,13,12,1
Pennsylvania,Dalton,1183,3,3,0
Pennsylvania,Danville,4642,9,8,1
Pennsylvania,Darby,10703,14,13,1
Pennsylvania,Darby Township,9281,14,13,1
Pennsylvania,Darlington Township,1863,1,1,0
Pennsylvania,Delmont,2510,5,5,0
Pennsylvania,Derry,2494,3,3,0
Pennsylvania,"Derry Township, Dauphin County",25313,41,39,2
Pennsylvania,Donegal Township,3252,2,2,0
Pennsylvania,Donora,4539,5,5,0
Pennsylvania,Dormont,8247,14,13,1
Pennsylvania,"Douglass Township, Berks County",3622,6,6,0
Pennsylvania,"Douglass Township, Montgomery County",10588,14,12,2
Pennsylvania,Downingtown,7898,22,18,4
Pennsylvania,Doylestown Township,17368,22,20,2
Pennsylvania,Dublin Borough,2130,2,2,0
Pennsylvania,DuBois,7319,14,13,1
Pennsylvania,Duncansville,1155,2,2,0
Pennsylvania,Dunmore,12837,21,20,1
Pennsylvania,Dupont,2679,2,2,0
Pennsylvania,Duquesne,5556,16,16,0
Pennsylvania,Duryea,4845,2,2,0
Pennsylvania,East Berlin,1548,3,1,2
Pennsylvania,East Brandywine Township,9346,17,15,2
Pennsylvania,East Cocalico Township,10713,16,15,1
Pennsylvania,East Coventry Township,6760,8,7,1
Pennsylvania,East Deer Township,1430,1,1,0
Pennsylvania,East Earl Township,6934,6,6,0
Pennsylvania,Eastern Adams Regional,7425,5,5,0
Pennsylvania,Eastern Pike Regional,4614,11,10,1
Pennsylvania,East Fallowfield Township,7568,7,7,0
Pennsylvania,East Franklin Township,3817,1,1,0
Pennsylvania,East Greenville,2942,3,3,0
Pennsylvania,East Hempfield Township,24831,37,33,4
Pennsylvania,East Lampeter Township,17103,41,38,3
Pennsylvania,East Lansdowne,2671,5,4,1
Pennsylvania,East Marlborough Township,7608,2,2,0
Pennsylvania,East Norriton Township,14010,29,28,1
Pennsylvania,Easton,27232,65,60,5
Pennsylvania,East Pennsboro Township,21556,23,22,1
Pennsylvania,East Pikeland Township,7574,11,11,0
Pennsylvania,Easttown Township,10652,14,13,1
Pennsylvania,East Vincent Township,7402,7,7,0
Pennsylvania,East Whiteland Township,13106,22,21,1
Pennsylvania,Ebensburg,3023,5,5,0
Pennsylvania,Economy,9108,14,13,1
Pennsylvania,Eddystone,2412,10,9,1
Pennsylvania,Edgewood,2991,8,8,0
Pennsylvania,Edgeworth,1643,5,4,1
Pennsylvania,Edinboro,5422,8,8,0
Pennsylvania,Edwardsville,4709,6,6,0
Pennsylvania,Elizabeth,1965,1,1,0
Pennsylvania,Elizabethtown,11436,18,16,2
Pennsylvania,Elizabeth Township,12916,12,12,0
Pennsylvania,Ellwood City,7227,11,10,1
Pennsylvania,Emmaus,11498,20,18,2
Pennsylvania,Emporium,1790,2,2,0
Pennsylvania,Ephrata,13920,34,31,3
Pennsylvania,Erie,94842,194,173,21
Pennsylvania,Etna,3294,7,6,1
Pennsylvania,Evans City-Seven Fields Regional,4417,5,5,0
Pennsylvania,Everett,1707,3,3,0
Pennsylvania,Exeter,5532,3,3,0
Pennsylvania,"Exeter Township, Berks County",25815,35,33,2
Pennsylvania,"Exeter Township, Luzerne County",2352,5,5,0
Pennsylvania,"Fairview Township, Luzerne County",4514,7,7,0
Pennsylvania,"Fairview Township, York County",17709,20,18,2
Pennsylvania,"Falls Township, Bucks County",33465,62,55,7
Pennsylvania,Farrell,4541,16,15,1
Pennsylvania,Fawn Township,2288,1,1,0
Pennsylvania,Ferguson Township,19646,24,22,2
Pennsylvania,Ferndale,1479,2,2,0
Pennsylvania,Findlay Township,6140,25,18,7
Pennsylvania,Fleetwood,4105,9,8,1
Pennsylvania,Folcroft,6633,13,12,1
Pennsylvania,Ford City,2741,3,3,0
Pennsylvania,Forest City,1725,2,2,0
Pennsylvania,Forest Hills,6272,9,9,0
Pennsylvania,Forks Township,15879,23,22,1
Pennsylvania,Forty Fort,4028,5,5,0
Pennsylvania,Forward Township,3260,1,1,0
Pennsylvania,Fountain Hill,4708,11,10,1
Pennsylvania,Fox Chapel,5062,11,11,0
Pennsylvania,Frackville,3590,5,5,0
Pennsylvania,Franconia Township,13400,11,10,1
Pennsylvania,Franklin,5956,25,15,10
Pennsylvania,Franklin Park,15042,19,17,2
Pennsylvania,"Franklin Township, Beaver County",3811,4,4,0
Pennsylvania,"Franklin Township, Carbon County",4169,4,4,0
Pennsylvania,Frazer Township,1116,2,2,0
Pennsylvania,Freedom Township,3318,3,3,0
Pennsylvania,Freemansburg,2627,3,3,0
Pennsylvania,Freeport,1663,2,2,0
Pennsylvania,Galeton,1070,1,1,0
Pennsylvania,Gallitzin,1738,2,2,0
Pennsylvania,Geistown,2250,3,3,0
Pennsylvania,German Township,4747,3,3,0
Pennsylvania,Gettysburg,7738,11,10,1
Pennsylvania,Gilpin Township,2379,2,2,0
Pennsylvania,Girard,2892,4,4,0
Pennsylvania,Glassport,4296,9,9,0
Pennsylvania,Glenolden,7165,9,8,1
Pennsylvania,Granville Township,4974,10,8,2
Pennsylvania,Greenfield Township,2008,1,1,0
Pennsylvania,"Greenfield Township, Blair County",3943,3,3,0
Pennsylvania,Greensburg,14030,32,26,6
Pennsylvania,Green Tree,4882,10,10,0
Pennsylvania,Greenville,5202,10,9,1
Pennsylvania,Grove City,7702,11,10,1
Pennsylvania,Hamburg,4369,7,6,1
Pennsylvania,Hampden Township,31034,26,25,1
Pennsylvania,Hampton Township,18161,20,19,1
Pennsylvania,Hanover,15767,26,24,2
Pennsylvania,"Hanover Township, Luzerne County",10797,18,18,0
Pennsylvania,Harmar Township,3006,8,8,0
Pennsylvania,Harmony Township,2974,11,11,0
Pennsylvania,Harrisburg,49244,159,129,30
Pennsylvania,Harrison Township,10211,14,13,1
Pennsylvania,Harveys Lake,2773,5,5,0
Pennsylvania,Hastings,1142,2,2,0
Pennsylvania,Hatboro,7516,18,15,3
Pennsylvania,Hatfield Township,21246,30,28,2
Pennsylvania,Haverford Township,49638,76,70,6
Pennsylvania,Hazleton,24726,41,39,2
Pennsylvania,Hegins Township,3346,2,2,0
Pennsylvania,Heidelberg,1203,4,4,0
Pennsylvania,Hellam Township,8626,12,12,0
Pennsylvania,Hellertown,5825,10,10,0
Pennsylvania,Hemlock Township,2261,9,9,0
Pennsylvania,"Hempfield Township, Mercer County",3535,8,7,1
Pennsylvania,Hermitage,15368,34,31,3
Pennsylvania,Highspire,2370,5,5,0
Pennsylvania,Hilltown Township,15911,19,17,2
Pennsylvania,Hollidaysburg,5664,11,9,2
Pennsylvania,Homer City,1576,1,1,0
Pennsylvania,Homestead,3144,11,10,1
Pennsylvania,Honesdale,4257,5,5,0
Pennsylvania,Honey Brook,1763,1,1,0
Pennsylvania,Hopewell Township,12583,17,16,1
Pennsylvania,Horsham Township,26522,47,40,7
Pennsylvania,Hughestown,1348,1,1,0
Pennsylvania,Hughesville,2019,3,3,0
Pennsylvania,Hummelstown,4857,7,6,1
Pennsylvania,Huntingdon,6920,12,12,0
Pennsylvania,"Independence Township, Beaver County",2323,2,2,0
Pennsylvania,Indiana,13084,20,19,1
Pennsylvania,Indiana Township,7109,10,10,0
Pennsylvania,Indian Lake,376,2,2,0
Pennsylvania,Ingram,3185,4,4,0
Pennsylvania,Irwin,3718,3,3,0
Pennsylvania,"Jackson Township, Butler County",4325,11,10,1
Pennsylvania,"Jackson Township, Cambria County",3967,3,3,0
Pennsylvania,"Jackson Township, Luzerne County",4662,7,7,0
Pennsylvania,Jeannette,9011,14,13,1
Pennsylvania,Jefferson Hills Borough,11152,20,19,1
Pennsylvania,"Jefferson Township, Mercer County",1794,2,2,0
Pennsylvania,Jenkins Township,4569,5,5,0
Pennsylvania,Jenkintown,4419,16,14,2
Pennsylvania,Jim Thorpe,4644,9,8,1
Pennsylvania,Johnsonburg,2271,3,3,0
Pennsylvania,Johnstown,20390,42,38,4
Pennsylvania,Kane,3419,4,4,0
Pennsylvania,Kennedy Township,8159,12,10,2
Pennsylvania,Kennett Square,6219,14,11,3
Pennsylvania,Kennett Township,8387,10,9,1
Pennsylvania,Kidder Township,1938,7,7,0
Pennsylvania,Kingston,12774,21,19,2
Pennsylvania,Kingston Township,6887,13,13,0
Pennsylvania,Kiskiminetas Township,4440,2,2,0
Pennsylvania,Kline Township,1353,1,1,0
Pennsylvania,Knox,1061,2,2,0
Pennsylvania,Kulpmont,2736,3,3,0
Pennsylvania,Kutztown,5090,14,12,2
Pennsylvania,Lake City,2835,3,3,0
Pennsylvania,Lancaster,59264,161,143,18
Pennsylvania,"Lancaster Township, Butler County",2802,4,4,0
Pennsylvania,Langhorne Borough,1576,1,1,0
Pennsylvania,Lansdale,17173,32,25,7
Pennsylvania,Lansdowne,10650,18,16,2
Pennsylvania,Lansford,3789,6,6,0
Pennsylvania,Latimore Township,2711,1,1,0
Pennsylvania,Latrobe,7777,15,14,1
Pennsylvania,Laureldale,3911,5,5,0
Pennsylvania,Lawrence Park Township,3718,8,8,0
Pennsylvania,"Lawrence Township, Clearfield County",7507,11,10,1
Pennsylvania,Lebanon,25925,41,38,3
Pennsylvania,Leechburg,1972,3,3,0
Pennsylvania,Leetsdale,1152,5,5,0
Pennsylvania,Leet Township,1579,4,4,0
Pennsylvania,Lehighton,5293,11,10,1
Pennsylvania,"Lehigh Township, Northampton County",10425,13,12,1
Pennsylvania,Lehman Township,3491,6,6,0
Pennsylvania,Lewistown,8102,14,13,1
Pennsylvania,Liberty,2443,1,1,0
Pennsylvania,"Liberty Township, Adams County",1270,1,1,0
Pennsylvania,Limerick Township,19441,31,29,2
Pennsylvania,Lincoln,1017,3,2,1
Pennsylvania,Linesville,970,1,1,0
Pennsylvania,Lititz,9499,15,14,1
Pennsylvania,Littlestown,4518,9,9,0
Pennsylvania,Lock Haven,9011,16,14,2
Pennsylvania,Locust Township,1375,5,5,0
Pennsylvania,Logan Township,12185,18,16,2
Pennsylvania,Lower Allen Township,20535,25,22,3
Pennsylvania,Lower Burrell,11006,18,17,1
Pennsylvania,Lower Chichester Township,3474,5,5,0
Pennsylvania,Lower Frederick Township,4936,4,4,0
Pennsylvania,Lower Gwynedd Township,11506,19,18,1
Pennsylvania,Lower Heidelberg Township,6259,11,10,1
Pennsylvania,Lower Makefield Township,32830,42,39,3
Pennsylvania,Lower Merion Township,60353,146,130,16
Pennsylvania,Lower Moreland Township,13125,31,26,5
Pennsylvania,Lower Paxton Township,50230,65,58,7
Pennsylvania,Lower Pottsgrove Township,12156,22,20,2
Pennsylvania,Lower Providence Township,27030,33,31,2
Pennsylvania,Lower Salford Township,15593,21,19,2
Pennsylvania,Lower Saucon Township,10845,16,15,1
Pennsylvania,Lower Southampton Township,19205,34,32,2
Pennsylvania,Lower Swatara Township,9001,18,16,2
Pennsylvania,Lower Windsor Township,7597,11,10,1
Pennsylvania,Luzerne,2808,3,3,0
Pennsylvania,Luzerne Township,5898,1,1,0
Pennsylvania,Lykens,1768,1,1,0
Pennsylvania,Macungie,3190,4,4,0
Pennsylvania,Mahanoy Township,3174,7,6,1
Pennsylvania,"Mahoning Township, Carbon County",4232,6,5,1
Pennsylvania,"Mahoning Township, Lawrence County",2835,2,2,0
Pennsylvania,"Mahoning Township, Montour County",4137,8,7,1
Pennsylvania,Malvern,3510,8,7,1
Pennsylvania,Manheim,4848,18,17,1
Pennsylvania,Manheim Township,40811,77,65,12
Pennsylvania,Manor,3360,4,4,0
Pennsylvania,"Manor Township, Armstrong County",4019,3,3,0
Pennsylvania,"Manor Township, Lancaster County",21177,21,19,2
Pennsylvania,Mansfield,2847,5,5,0
Pennsylvania,Marcus Hook,2403,6,5,1
Pennsylvania,"Marion Township, Beaver County",864,2,2,0
Pennsylvania,Marlborough Township,3404,4,4,0
Pennsylvania,Marple Township,24015,34,31,3
Pennsylvania,Martinsburg,1824,3,3,0
Pennsylvania,Marysville,2562,2,2,0
Pennsylvania,Masontown,3257,4,4,0
Pennsylvania,Mayfield,1683,2,2,0
Pennsylvania,McAdoo,2141,3,3,0
Pennsylvania,McCandless,28151,31,29,2
Pennsylvania,McDonald Borough,2040,6,5,1
Pennsylvania,McKeesport,20647,43,40,3
Pennsylvania,McKees Rocks,5830,10,9,1
Pennsylvania,McSherrystown,3096,5,5,0
Pennsylvania,Meadville,12579,27,22,5
Pennsylvania,Mechanicsburg,8992,18,16,2
Pennsylvania,Media,5724,16,15,1
Pennsylvania,Mercer,1865,4,4,0
Pennsylvania,Mercersburg,1530,2,2,0
Pennsylvania,Meshoppen,1411,2,2,0
Pennsylvania,Meyersdale,2002,5,5,0
Pennsylvania,Middleburg,1267,4,3,1
Pennsylvania,"Middlesex Township, Butler County",5839,4,4,0
Pennsylvania,"Middlesex Township, Cumberland County",7455,13,12,1
Pennsylvania,Middletown,9669,11,11,0
Pennsylvania,Middletown Township,44918,63,58,5
Pennsylvania,Midland,2451,4,4,0
Pennsylvania,Mifflinburg,3470,8,7,1
Pennsylvania,Mifflin County Regional,16897,14,14,0
Pennsylvania,Milford,978,2,2,0
Pennsylvania,Millbourne,1160,1,1,0
Pennsylvania,"Millcreek Township, Erie County",52329,78,61,17
Pennsylvania,"Millcreek Township, Lebanon County",5842,2,2,0
Pennsylvania,Millersburg,2515,3,2,1
Pennsylvania,Millersville,8385,15,13,2
Pennsylvania,Millvale,3646,7,7,0
Pennsylvania,Milton,6563,9,8,1
Pennsylvania,Minersville,4131,6,6,0
Pennsylvania,Mohnton,3021,3,3,0
Pennsylvania,Monaca,5387,11,11,0
Pennsylvania,Monessen,7186,13,12,1
Pennsylvania,Monongahela,9749,8,7,1
Pennsylvania,Monroeville,27275,56,46,10
Pennsylvania,Montgomery Township,26315,45,36,9
Pennsylvania,Montoursville,4375,7,6,1
Pennsylvania,Montrose,1462,5,5,0
Pennsylvania,Moon Township,25575,38,30,8
Pennsylvania,Moore Township,9456,12,11,1
Pennsylvania,Moosic,5845,9,9,0
Pennsylvania,Morrisville,8499,11,11,0
Pennsylvania,Morton,2672,5,5,0
Pennsylvania,Moscow,2037,2,2,0
Pennsylvania,Mount Carmel,5709,9,9,0
Pennsylvania,Mount Carmel Township,2959,7,7,0
Pennsylvania,Mount Holly Springs,2055,4,4,0
Pennsylvania,Mount Joy,8378,12,11,1
Pennsylvania,Mount Lebanon,31799,54,43,11
Pennsylvania,Mount Oliver,3267,10,10,0
Pennsylvania,Mount Pleasant,4199,3,3,0
Pennsylvania,Mount Pleasant Township,3517,5,5,0
Pennsylvania,Mount Union,2327,4,4,0
Pennsylvania,Muhlenberg Township,20417,30,28,2
Pennsylvania,Muncy,2404,3,3,0
Pennsylvania,Muncy Township,1202,2,2,0
Pennsylvania,Munhall,10965,26,24,2
Pennsylvania,Murrysville,19537,23,21,2
Pennsylvania,Nanticoke,10296,12,11,1
Pennsylvania,Nanty Glo,2445,2,2,0
Pennsylvania,Narberth,4342,10,6,4
Pennsylvania,Nazareth,5698,6,5,1
Pennsylvania,Neshannock Township,9163,8,8,0
Pennsylvania,Nesquehoning,3240,5,5,0
Pennsylvania,Nether Providence Township,13788,15,14,1
Pennsylvania,Newberry Township,15989,19,17,2
Pennsylvania,New Bethlehem,2686,3,3,0
Pennsylvania,New Brighton,8627,9,9,0
Pennsylvania,New Britain Township,11568,14,13,1
Pennsylvania,New Castle,21445,40,37,3
Pennsylvania,New Cumberland,7289,10,9,1
Pennsylvania,New Hanover Township,13483,12,11,1
Pennsylvania,New Holland,5472,15,15,0
Pennsylvania,New Hope,2530,10,9,1
Pennsylvania,New Kensington,12205,26,22,4
Pennsylvania,Newport Township,5340,5,5,0
Pennsylvania,New Sewickley Township,7136,11,10,1
Pennsylvania,Newtown,2238,6,6,0
Pennsylvania,"Newtown Township, Bucks County",22723,33,29,4
Pennsylvania,"Newtown Township, Delaware County",14150,22,20,2
Pennsylvania,Newville,1349,4,4,0
Pennsylvania,New Wilmington,2170,5,5,0
Pennsylvania,Norristown,34339,81,68,13
Pennsylvania,Northampton,9867,15,13,2
Pennsylvania,Northampton Township,39103,49,43,6
Pennsylvania,North Belle Vernon,1844,2,2,0
Pennsylvania,North Braddock,4648,1,1,0
Pennsylvania,North Catasauqua,2829,4,4,0
Pennsylvania,North Cornwall Township,7972,10,9,1
Pennsylvania,North Coventry Township,7969,13,12,1
Pennsylvania,"North East, Erie County",4006,7,7,0
Pennsylvania,Northeastern Regional,11992,13,12,1
Pennsylvania,Northern Berks Regional,13537,14,13,1
Pennsylvania,Northern Cambria Borough,3471,3,3,0
Pennsylvania,Northern Lancaster County Regional,41322,35,31,4
Pennsylvania,Northern Regional,36504,42,40,2
Pennsylvania,Northern York County Regional,86465,64,60,4
Pennsylvania,North Fayette Township,14913,25,21,4
Pennsylvania,North Hopewell Township,2768,2,2,0
Pennsylvania,North Huntingdon Township,30350,34,28,6
Pennsylvania,North Lebanon Township,12272,14,12,2
Pennsylvania,North Londonderry Township,8658,10,9,1
Pennsylvania,North Middleton Township,11886,11,10,1
Pennsylvania,North Sewickley Township,5357,1,1,0
Pennsylvania,North Strabane Township,14596,26,25,1
Pennsylvania,Northumberland,3587,6,6,0
Pennsylvania,North Versailles Township,11992,24,19,5
Pennsylvania,North Wales,3268,5,5,0
Pennsylvania,North Woodbury,2589,2,2,0
Pennsylvania,Norwood,5898,7,6,1
Pennsylvania,Oakmont,6568,7,7,0
Pennsylvania,O'Hara Township,8788,17,16,1
Pennsylvania,Ohio Township,7209,20,18,2
Pennsylvania,Ohioville,3264,2,2,0
Pennsylvania,Oil City,9521,17,16,1
Pennsylvania,Old Forge,7849,7,7,0
Pennsylvania,Old Lycoming Township,4907,10,9,1
Pennsylvania,Olyphant,5008,7,7,0
Pennsylvania,Orangeville Area,3568,1,1,0
Pennsylvania,Orwigsburg,2936,6,6,0
Pennsylvania,Oxford,5640,10,9,1
Pennsylvania,Palmerton,5326,10,9,1
Pennsylvania,Palmer Township,21506,37,35,2
Pennsylvania,Palmyra,7616,12,11,1
Pennsylvania,Parkesburg,4040,8,7,1
Pennsylvania,Parkside,2330,1,1,0
Pennsylvania,Parks Township,2545,2,2,0
Pennsylvania,Patterson Township,4125,4,4,0
Pennsylvania,Patton,1581,2,2,0
Pennsylvania,Patton Township,15874,22,20,2
Pennsylvania,Penbrook,2982,7,7,0
Pennsylvania,Penndel,2140,1,1,0
Pennsylvania,Penn Hills,40636,52,49,3
Pennsylvania,Pennridge Regional,10946,12,11,1
Pennsylvania,"Penn Township, Butler County",4858,5,4,1
Pennsylvania,"Penn Township, Westmoreland County",19275,24,22,2
Pennsylvania,"Penn Township, York County",16737,25,22,3
Pennsylvania,Perkasie,8765,19,17,2
Pennsylvania,Perryopolis,1653,2,2,0
Pennsylvania,Peters Township,22137,26,25,1
Pennsylvania,Philadelphia,1586666,7140,6359,781
Pennsylvania,Phoenixville,17024,32,31,1
Pennsylvania,Pine Creek Township,3222,2,2,0
Pennsylvania,Pine Grove,2056,2,2,0
Pennsylvania,Pitcairn,3144,2,2,0
Pennsylvania,Pittsburgh,298608,1036,998,38
Pennsylvania,Pittston Township,3359,6,6,0
Pennsylvania,Plains Township,9636,20,20,0
Pennsylvania,Pleasant Hills,8001,20,18,2
Pennsylvania,Plum,27082,29,27,2
Pennsylvania,Plumstead Township,14730,18,16,2
Pennsylvania,"Plymouth Township, Montgomery County",17645,52,45,7
Pennsylvania,Pocono Mountain Regional,43250,48,43,5
Pennsylvania,Pocono Township,11091,20,19,1
Pennsylvania,Point Township,3582,6,6,0
Pennsylvania,Polk,763,2,2,0
Pennsylvania,Portage,2357,2,2,0
Pennsylvania,Port Allegany,1982,3,3,0
Pennsylvania,Port Vue,3635,2,2,0
Pennsylvania,Pottstown,22626,58,44,14
Pennsylvania,Pottsville,13384,24,23,1
Pennsylvania,Prospect Park,6496,9,8,1
Pennsylvania,"Pulaski Township, Lawrence County",3207,2,2,0
Pennsylvania,Punxsutawney,5678,10,9,1
Pennsylvania,Pymatuning Township,3004,10,7,3
Pennsylvania,Quakertown,8762,24,21,3
Pennsylvania,Quarryville,2774,5,5,0
Pennsylvania,Raccoon Township,2884,4,4,0
Pennsylvania,Radnor Township,31910,46,42,4
Pennsylvania,Ralpho Township,4184,6,6,0
Pennsylvania,Rankin,2018,1,1,0
Pennsylvania,Reading,88412,186,162,24
Pennsylvania,Reading Township,5902,2,2,0
Pennsylvania,Redstone Township,4136,2,2,0
Pennsylvania,Renovo,1202,1,1,0
Pennsylvania,Reserve Township,3212,6,6,0
Pennsylvania,Reynoldsville,2635,2,2,0
Pennsylvania,Rice Township,3570,6,6,0
Pennsylvania,"Richland Township, Bucks County",13357,18,16,2
Pennsylvania,"Richland Township, Cambria County",11715,21,20,1
Pennsylvania,Ridgway,3717,8,7,1
Pennsylvania,Ridley Park,7070,10,10,0
Pennsylvania,Ridley Township,31242,35,32,3
Pennsylvania,Riverside,1845,3,3,0
Pennsylvania,Roaring Brook Township,1989,2,2,0
Pennsylvania,Roaring Spring,2421,3,3,0
Pennsylvania,Robeson Township,7457,5,5,0
Pennsylvania,"Robinson Township, Allegheny County",13904,29,28,1
Pennsylvania,Rochester,3416,8,7,1
Pennsylvania,Rochester Township,2617,3,3,0
Pennsylvania,Rockledge,2529,5,5,0
Pennsylvania,Ross Township,30403,44,43,1
Pennsylvania,Rostraver Township,10970,18,17,1
Pennsylvania,Royalton,1036,1,1,0
Pennsylvania,Royersford,4753,9,8,1
Pennsylvania,Rural Valley,807,1,1,0
Pennsylvania,Rush Township,3241,1,1,0
Pennsylvania,"Sadsbury Township, Chester County",4174,4,4,0
Pennsylvania,"Salem Township, Luzerne County",4189,7,7,0
Pennsylvania,Salisbury Township,13985,21,19,2
Pennsylvania,Sandy Lake,621,1,1,0
Pennsylvania,Sandy Township,10422,13,12,1
Pennsylvania,Saxonburg,1429,2,2,0
Pennsylvania,Saxton,676,3,3,0
Pennsylvania,Sayre,6334,13,11,2
Pennsylvania,Schuylkill Haven,5069,8,8,0
Pennsylvania,"Schuylkill Township, Chester County",8626,13,11,2
Pennsylvania,Scottdale,4066,6,6,0
Pennsylvania,"Scott Township, Allegheny County",16362,22,21,1
Pennsylvania,"Scott Township, Columbia County",5048,8,8,0
Pennsylvania,"Scott Township, Lackawanna County",4729,4,4,0
Pennsylvania,Scranton,76719,153,140,13
Pennsylvania,Selinsgrove,5931,6,5,1
Pennsylvania,Sewickley Heights,806,3,3,0
Pennsylvania,Shaler Township,27612,28,26,2
Pennsylvania,Shamokin,6908,10,10,0
Pennsylvania,Shamokin Dam,1709,3,3,0
Pennsylvania,Sharon,12820,31,30,1
Pennsylvania,Sharon Hill,5690,12,11,1
Pennsylvania,Sharpsburg,3304,6,6,0
Pennsylvania,Sharpsville,4038,6,6,0
Pennsylvania,Shenandoah,4727,6,6,0
Pennsylvania,"Shenango Township, Lawrence County",7080,8,8,0
Pennsylvania,"Shenango Township, Mercer County",3648,11,11,0
Pennsylvania,Shillington,5322,7,6,1
Pennsylvania,Shinglehouse,1046,1,1,0
Pennsylvania,Shippensburg,5570,11,10,1
Pennsylvania,Shippingport,187,2,2,0
Pennsylvania,Shiremanstown,1629,2,2,0
Pennsylvania,Silver Spring Township,18910,24,23,1
Pennsylvania,Sinking Spring,4119,7,6,1
Pennsylvania,Slate Belt Regional,12530,21,20,1
Pennsylvania,Slatington,4316,6,6,0
Pennsylvania,Slippery Rock,3518,4,4,0
Pennsylvania,Smethport,1517,2,2,0
Pennsylvania,Smith Township,4341,5,5,0
Pennsylvania,Solebury Township,8537,18,16,2
Pennsylvania,Somerset,5810,8,7,1
Pennsylvania,Souderton,7134,7,6,1
Pennsylvania,South Abington Township,8872,11,10,1
Pennsylvania,South Beaver Township,2637,4,4,0
Pennsylvania,South Buffalo Township,2506,2,2,0
Pennsylvania,South Coatesville,1472,2,2,0
Pennsylvania,South Connellsville Borough,1853,1,1,0
Pennsylvania,Southern Chester County Regional,16477,20,18,2
Pennsylvania,Southern Regional York County,12864,16,15,1
Pennsylvania,South Fayette Township,16123,21,20,1
Pennsylvania,South Fork,833,1,1,0
Pennsylvania,South Greensburg,1983,2,2,0
Pennsylvania,South Heidelberg Township,12368,14,14,0
Pennsylvania,South Park Township,13650,16,15,1
Pennsylvania,South Pymatuning Township,2494,4,4,0
Pennsylvania,South Strabane Township,9439,21,20,1
Pennsylvania,Southwest Greensburg,2004,11,11,0
Pennsylvania,"Southwest Regional, Fayette County",2620,1,1,0
Pennsylvania,"Southwest Regional, Washington County",130,1,1,0
Pennsylvania,South Whitehall Township,20042,41,39,2
Pennsylvania,Spring City,3301,3,3,0
Pennsylvania,Springdale,3275,4,4,0
Pennsylvania,Springettsbury Township,26884,32,29,3
Pennsylvania,"Springfield Township, Bucks County",5032,4,4,0
Pennsylvania,"Springfield Township, Delaware County",24276,39,34,5
Pennsylvania,"Springfield Township, Montgomery County",19901,31,29,2
Pennsylvania,Spring Garden Township,13293,24,20,4
Pennsylvania,"Spring Township, Berks County",27717,29,28,1
Pennsylvania,"Spring Township, Centre County",8120,9,8,1
Pennsylvania,State College,58471,65,55,10
Pennsylvania,St. Clair Boro,2811,5,5,0
Pennsylvania,Steelton,5959,15,14,1
Pennsylvania,St. Marys City,12177,16,15,1
Pennsylvania,Stockertown,926,1,1,0
Pennsylvania,Stoneboro,973,1,1,0
Pennsylvania,Stonycreek Township,2558,4,4,0
Pennsylvania,Stowe Township,6095,11,10,1
Pennsylvania,Strasburg,3053,5,5,0
Pennsylvania,Stroud Area Regional,35441,56,47,9
Pennsylvania,Sugarcreek,4861,2,2,0
Pennsylvania,Summerhill Township,2236,2,2,0
Pennsylvania,Summit Hill,2946,5,5,0
Pennsylvania,Summit Township,2101,1,1,0
Pennsylvania,Sunbury,9306,10,8,2
Pennsylvania,Susquehanna Regional,8433,16,14,2
Pennsylvania,"Susquehanna Township, Dauphin County",25233,44,40,4
Pennsylvania,Swarthmore,6364,8,8,0
Pennsylvania,Swatara Township,26820,53,50,3
Pennsylvania,Sweden Township,812,1,1,0
Pennsylvania,Swissvale,8609,15,15,0
Pennsylvania,Swoyersville,4997,5,5,0
Pennsylvania,Sykesville,1110,1,1,0
Pennsylvania,Tamaqua,6617,10,9,1
Pennsylvania,Tarentum,4347,10,10,0
Pennsylvania,Tatamy,1173,2,2,0
Pennsylvania,Taylor,5876,8,8,0
Pennsylvania,Throop,3875,8,8,0
Pennsylvania,Tiadaghton Valley Regional,7512,11,11,0
Pennsylvania,Tilden Township,3622,4,4,0
Pennsylvania,"Tinicum Township, Bucks County",3948,3,3,0
Pennsylvania,"Tinicum Township, Delaware County",4113,18,16,2
Pennsylvania,Tioga,645,2,1,1
Pennsylvania,Titusville,5112,11,11,0
Pennsylvania,Towamencin Township,18536,25,23,2
Pennsylvania,Towanda,2797,6,6,0
Pennsylvania,Trafford,3019,5,5,0
Pennsylvania,Tredyffrin Township,29401,47,42,5
Pennsylvania,Troy,1224,2,2,0
Pennsylvania,Tullytown,2176,5,4,1
Pennsylvania,Tulpehocken Township,3477,3,3,0
Pennsylvania,Tunkhannock,1683,3,3,0
Pennsylvania,"Tunkhannock Township, Wyoming County",5998,8,8,0
Pennsylvania,Turtle Creek,5116,5,5,0
Pennsylvania,Tyrone,5105,9,7,2
Pennsylvania,Union City,3096,4,3,1
Pennsylvania,Uniontown,9653,21,20,1
Pennsylvania,"Union Township, Lawrence County",4817,11,11,0
Pennsylvania,Upland,3327,8,7,1
Pennsylvania,Upper Allen Township,20655,24,23,1
Pennsylvania,Upper Burrell Township,2201,2,2,0
Pennsylvania,Upper Chichester Township,16987,24,23,1
Pennsylvania,Upper Darby Township,82947,128,116,12
Pennsylvania,Upper Dublin Township,26658,42,37,5
Pennsylvania,Upper Gwynedd Township,15850,24,21,3
Pennsylvania,Upper Macungie Township,25811,32,29,3
Pennsylvania,Upper Makefield Township,8646,17,16,1
Pennsylvania,Upper Merion Township,33595,86,70,16
Pennsylvania,Upper Moreland Township,24031,43,37,6
Pennsylvania,Upper Nazareth Township,7161,10,9,1
Pennsylvania,Upper Perkiomen,3856,4,4,0
Pennsylvania,Upper Pottsgrove Township,5799,9,9,0
Pennsylvania,"Upper Providence Township, Delaware County",10479,16,15,1
Pennsylvania,"Upper Providence Township, Montgomery County",24725,29,27,2
Pennsylvania,Upper Saucon Township,17603,25,23,2
Pennsylvania,Upper Southampton Township,14934,25,22,3
Pennsylvania,Upper St. Clair Township,19791,35,28,7
Pennsylvania,Upper Uwchlan Township,11887,12,12,0
Pennsylvania,Upper Yoder Township,4989,6,6,0
Pennsylvania,Uwchlan Township,18924,24,23,1
Pennsylvania,Valley Township,7884,7,7,0
Pennsylvania,Vernon Township,5341,4,4,0
Pennsylvania,Verona,2401,4,3,1
Pennsylvania,Versailles,1455,2,2,0
Pennsylvania,Walnutport,2089,4,4,0
Pennsylvania,Warminster Township,32300,47,43,4
Pennsylvania,Warren,8979,18,16,2
Pennsylvania,Warrington Township,24689,37,36,1
Pennsylvania,"Warwick Township, Bucks County",14725,18,17,1
Pennsylvania,"Washington Township, Fayette County",3575,4,4,0
Pennsylvania,"Washington Township, Franklin County",14853,12,10,2
Pennsylvania,"Washington Township, Westmoreland County",7023,9,9,0
Pennsylvania,"Washington, Washington County",13371,33,31,2
Pennsylvania,Watsontown,2241,6,6,0
Pennsylvania,Waverly Township,1676,3,3,0
Pennsylvania,Waynesboro,10921,21,19,2
Pennsylvania,Waynesburg,3941,8,8,0
Pennsylvania,Weatherly,2451,4,4,0
Pennsylvania,Wellsboro,3223,7,7,0
Pennsylvania,Wesleyville,3093,8,7,1
Pennsylvania,West Brandywine Township,7474,10,9,1
Pennsylvania,West Caln Township,9120,4,4,0
Pennsylvania,West Chester,20211,57,44,13
Pennsylvania,West Conshohocken,1445,13,12,1
Pennsylvania,West Deer Township,12009,15,14,1
Pennsylvania,West Earl Township,8457,8,7,1
Pennsylvania,West Fallowfield Township,2592,2,2,0
Pennsylvania,West Goshen Township,23100,36,32,4
Pennsylvania,West Hazleton,4342,5,5,0
Pennsylvania,West Hempfield Township,16808,22,21,1
Pennsylvania,West Hills Regional,9793,12,11,1
Pennsylvania,West Homestead,1857,13,12,1
Pennsylvania,West Lampeter Township,16036,19,17,2
Pennsylvania,West Mahanoy Township,2693,3,3,0
Pennsylvania,West Manchester Township,18808,32,28,4
Pennsylvania,West Manheim Township,8765,11,11,0
Pennsylvania,West Mead Township,4994,2,2,0
Pennsylvania,West Mifflin,19632,40,33,7
Pennsylvania,West Newton,2462,2,2,0
Pennsylvania,West Norriton Township,15608,30,27,3
Pennsylvania,West Penn Township,4278,2,2,0
Pennsylvania,West Pikeland Township,4071,4,4,0
Pennsylvania,West Pike Run,1525,1,1,0
Pennsylvania,West Pittston,4746,3,3,0
Pennsylvania,West Pottsgrove Township,3836,6,6,0
Pennsylvania,West Reading,4298,17,15,2
Pennsylvania,West Sadsbury Township,2504,5,5,0
Pennsylvania,West Shore Regional,7696,13,12,1
Pennsylvania,Westtown-East Goshen Regional,32317,32,29,3
Pennsylvania,West View,6489,11,10,1
Pennsylvania,West Vincent Township,6081,7,6,1
Pennsylvania,West Whiteland Township,19923,29,27,2
Pennsylvania,Whitehall,13352,24,19,5
Pennsylvania,Whitehall Township,27953,52,47,5
Pennsylvania,White Haven Borough,1100,1,1,0
Pennsylvania,Whitemarsh Township,18453,42,36,6
Pennsylvania,White Oak,7398,14,13,1
Pennsylvania,Whitpain Township,19279,37,29,8
Pennsylvania,Wiconisco Township,1204,1,1,0
Pennsylvania,Wilkes-Barre,40683,83,79,4
Pennsylvania,Wilkes-Barre Township,2875,15,14,1
Pennsylvania,Wilkinsburg,15230,26,24,2
Pennsylvania,Wilkins Township,6109,12,12,0
Pennsylvania,Williamsburg,1169,2,2,0
Pennsylvania,Williamsport,28055,50,46,4
Pennsylvania,Willistown Township,11071,18,16,2
Pennsylvania,Wilson,7797,15,14,1
Pennsylvania,Windber,3780,3,2,1
Pennsylvania,Womelsdorf,2912,3,3,0
Pennsylvania,Woodward Township,2361,2,2,0
Pennsylvania,Wright Township,5625,7,6,1
Pennsylvania,Wyoming,3004,4,4,0
Pennsylvania,Wyomissing,10658,21,20,1
Pennsylvania,Yardley,2522,5,5,0
Pennsylvania,Yeadon,11502,18,17,1
Pennsylvania,York,43940,109,92,17
Pennsylvania,York Area Regional,56505,51,46,5
Pennsylvania,Youngsville,1600,2,2,0
Pennsylvania,Zelienople,3580,9,8,1
Pennsylvania,Zerbe Township,1743,1,1,0
Rhode Island,Barrington,15986,32,25,7
Rhode Island,Bristol,21748,49,40,9
Rhode Island,Burrillville,16904,32,25,7
Rhode Island,Central Falls,19530,46,38,8
Rhode Island,Charlestown,7803,25,20,5
Rhode Island,Coventry,34740,81,57,24
Rhode Island,Cranston,81313,178,148,30
Rhode Island,Cumberland,35357,51,42,9
Rhode Island,East Greenwich,13084,38,31,7
Rhode Island,East Providence,47542,110,92,18
Rhode Island,Foster,4747,13,9,4
Rhode Island,Glocester,10358,21,16,5
Rhode Island,Hopkinton,8025,19,14,5
Rhode Island,Jamestown,5493,19,14,5
Rhode Island,Johnston,29458,78,65,13
Rhode Island,Lincoln,22029,43,35,8
Rhode Island,Little Compton,3463,14,10,4
Rhode Island,Middletown,15817,40,36,4
Rhode Island,Narragansett,15248,51,38,13
Rhode Island,Newport,24202,100,83,17
Rhode Island,New Shoreham,1025,11,5,6
Rhode Island,North Kingstown,26221,60,52,8
Rhode Island,North Providence,32652,68,61,7
Rhode Island,North Smithfield,12616,33,26,7
Rhode Island,Pawtucket,72017,171,140,31
Rhode Island,Portsmouth,17162,39,36,3
Rhode Island,Providence,179603,510,420,90
Rhode Island,Richmond,7724,16,14,2
Rhode Island,Scituate,10739,24,15,9
Rhode Island,Smithfield,21893,54,40,14
Rhode Island,South Kingstown,30238,67,52,15
Rhode Island,Tiverton,15604,40,27,13
Rhode Island,Warren,10469,30,25,5
Rhode Island,Warwick,80605,201,165,36
Rhode Island,Westerly,22277,66,51,15
Rhode Island,West Greenwich,6399,19,13,6
Rhode Island,West Warwick,28831,58,48,10
Rhode Island,Woonsocket,41693,113,100,13
South Carolina,Abbeville,4990,20,19,1
South Carolina,Aiken,31007,117,87,30
South Carolina,Allendale,2870,6,6,0
South Carolina,Anderson,27815,144,106,38
South Carolina,Atlantic Beach,459,5,4,1
South Carolina,Aynor,1025,6,6,0
South Carolina,Bamberg,3147,10,8,2
South Carolina,Barnwell,4241,17,15,2
South Carolina,Batesburg-Leesville,5419,31,26,5
South Carolina,Beaufort,13561,50,45,5
South Carolina,Belton,4488,14,13,1
South Carolina,Bennettsville,7591,29,27,2
South Carolina,Bethune,352,1,1,0
South Carolina,Blacksburg,1885,11,11,0
South Carolina,Blackville,2166,8,7,1
South Carolina,Bluffton,27549,63,57,6
South Carolina,Bonneau,490,4,2,2
South Carolina,Bowman,880,4,2,2
South Carolina,Branchville,946,3,2,1
South Carolina,Burnettown,2762,2,2,0
South Carolina,Calhoun Falls,1892,4,4,0
South Carolina,Camden,7264,33,29,4
South Carolina,Cameron,396,1,1,0
South Carolina,Campobello,601,11,10,1
South Carolina,Cayce,14117,83,56,27
South Carolina,Central,5407,12,11,1
South Carolina,Chapin,1657,6,6,0
South Carolina,Charleston,139582,505,409,96
South Carolina,Cheraw,5529,29,23,6
South Carolina,Chesnee,969,6,5,1
South Carolina,Chester,5354,21,19,2
South Carolina,Chesterfield,1409,5,5,0
South Carolina,Clemson,17951,42,31,11
South Carolina,Clover,6693,22,17,5
South Carolina,Columbia,131777,431,343,88
South Carolina,Conway,27120,59,52,7
South Carolina,Coward,773,1,1,0
South Carolina,Cowpens,2450,9,7,2
South Carolina,Darlington,5895,35,32,3
South Carolina,Denmark,2876,10,9,1
South Carolina,Dillon,6261,25,23,2
South Carolina,Due West,1200,5,5,0
South Carolina,Duncan,3679,23,22,1
South Carolina,Easley,21512,58,48,10
South Carolina,Edgefield,4816,10,10,0
South Carolina,Edisto Beach,405,7,7,0
South Carolina,Ehrhardt,476,2,1,1
South Carolina,Elgin,1616,7,5,2
South Carolina,Elloree,635,3,3,0
South Carolina,Estill,1838,7,6,1
South Carolina,Eutawville,288,2,2,0
South Carolina,Florence,38597,91,78,13
South Carolina,Folly Beach,2676,23,17,6
South Carolina,Forest Acres,10283,33,26,7
South Carolina,Fort Lawn,885,3,2,1
South Carolina,Fort Mill,23966,65,56,9
South Carolina,Fountain Inn,10820,33,25,8
South Carolina,Gaffney,12631,38,34,4
South Carolina,Gaston,1706,3,3,0
South Carolina,Georgetown,8697,34,29,5
South Carolina,Gifford,260,5,2,3
South Carolina,Goose Creek,44522,88,65,23
South Carolina,Great Falls,1866,5,5,0
South Carolina,Greeleyville,375,1,1,0
South Carolina,Greenville,72014,249,206,43
South Carolina,Greenwood,23422,54,49,5
South Carolina,Greer,34320,79,59,20
South Carolina,Hampton,2474,14,13,1
South Carolina,Hanahan,28143,32,30,2
South Carolina,Hardeeville,7970,27,25,2
South Carolina,Harleyville,702,2,2,0
South Carolina,Hartsville,7519,40,38,2
South Carolina,Holly Hill,1168,6,6,0
South Carolina,Honea Path,3857,15,13,2
South Carolina,Irmo,12639,26,23,3
South Carolina,Isle of Palms,4385,27,18,9
South Carolina,Iva,1335,9,9,0
South Carolina,Jackson,1812,4,3,1
South Carolina,Johnsonville,1484,7,6,1
South Carolina,Johnston,2382,9,9,0
South Carolina,Jonesville,831,3,3,0
South Carolina,Kingstree,3035,9,6,3
South Carolina,Lake City,6477,22,22,0
South Carolina,Lake View,752,3,3,0
South Carolina,Landrum,2713,13,11,2
South Carolina,Lane,446,4,1,3
South Carolina,Latta,1275,9,8,1
South Carolina,Laurens,8830,32,26,6
South Carolina,Lexington,22592,64,61,3
South Carolina,Liberty,3143,15,10,5
South Carolina,Loris,2804,14,11,3
South Carolina,Lyman,3768,13,13,0
South Carolina,Manning,3869,20,19,1
South Carolina,Marion,6268,19,16,3
South Carolina,Mauldin,25662,59,47,12
South Carolina,McColl,1949,7,6,1
South Carolina,McCormick,2310,6,6,0
South Carolina,Moncks Corner,12580,33,29,4
South Carolina,Mount Pleasant,94704,175,158,17
South Carolina,Mullins,4196,21,16,5
South Carolina,Myrtle Beach,35658,304,203,101
South Carolina,Newberry,10181,27,25,2
South Carolina,New Ellenton,2164,2,2,0
South Carolina,Nichols,332,1,1,0
South Carolina,Ninety Six,2042,8,8,0
South Carolina,North,702,5,5,0
South Carolina,North Augusta,24139,92,65,27
South Carolina,North Charleston,117503,396,321,75
South Carolina,North Myrtle Beach,17183,147,80,67
South Carolina,Orangeburg,12529,68,38,30
South Carolina,Pageland,2629,14,10,4
South Carolina,Pamplico,1219,3,3,0
South Carolina,Pawleys Island,109,5,4,1
South Carolina,Pelion,714,2,2,0
South Carolina,Port Royal,13553,26,25,1
South Carolina,Prosperity,1295,4,4,0
South Carolina,Quinby,922,1,1,0
South Carolina,Ridgeland,3788,14,13,1
South Carolina,Ridge Spring,749,2,2,0
South Carolina,Ridgeville,1678,1,1,0
South Carolina,Rock Hill,76016,201,152,49
South Carolina,Salley,417,1,1,0
South Carolina,Saluda,3610,9,8,1
South Carolina,Scranton,863,2,1,1
South Carolina,Seneca,8581,44,30,14
South Carolina,Simpsonville,24960,55,44,11
South Carolina,South Congaree,2504,7,6,1
South Carolina,Spartanburg,37469,143,120,23
South Carolina,Springdale,2745,12,11,1
South Carolina,Springfield,479,3,3,0
South Carolina,St. George,2217,12,10,2
South Carolina,St. Matthews,1901,7,6,1
South Carolina,Sullivans Island,1939,12,10,2
South Carolina,Summerton,921,5,5,0
South Carolina,Summerville,53711,140,116,24
South Carolina,Sumter,39542,155,111,44
South Carolina,Surfside Beach,4608,22,17,5
South Carolina,Swansea,974,3,3,0
South Carolina,Tega Cay,11813,34,26,8
South Carolina,Travelers Rest,5435,22,16,6
South Carolina,Trenton,199,1,1,0
South Carolina,Union,7565,28,25,3
South Carolina,Wagener,841,2,2,0
South Carolina,Walhalla,4498,14,13,1
South Carolina,Walterboro,5387,33,31,2
South Carolina,Ware Shoals,2152,7,7,0
South Carolina,Wellford,2754,10,8,2
South Carolina,West Columbia,18143,63,53,10
South Carolina,West Pelzer,954,4,3,1
South Carolina,West Union,337,3,3,0
South Carolina,Whitmire,1455,4,3,1
South Carolina,Williamston,4294,19,18,1
South Carolina,Winnsboro,3144,18,17,1
South Carolina,Woodruff,4457,11,10,1
South Carolina,York,8486,40,34,6
South Dakota,Aberdeen,28494,58,49,9
South Dakota,Alcester,749,2,2,0
South Dakota,Avon,590,1,1,0
South Dakota,Belle Fourche,5712,13,11,2
South Dakota,Beresford,2028,5,5,0
South Dakota,Box Elder,10402,19,18,1
South Dakota,Brandon,10205,14,13,1
South Dakota,Brookings,24682,47,35,12
South Dakota,Burke,584,1,1,0
South Dakota,Canton,3615,6,6,0
South Dakota,Centerville,870,2,2,0
South Dakota,Chamberlain,2364,6,6,0
South Dakota,Clark,1053,2,2,0
South Dakota,Deadwood,1293,18,15,3
South Dakota,Eagle Butte,1349,1,1,0
South Dakota,Elk Point,1860,5,5,0
South Dakota,Faith,410,1,1,0
South Dakota,Flandreau,2314,8,7,1
South Dakota,Freeman,1272,2,2,0
South Dakota,Gettysburg,1070,2,2,0
South Dakota,Groton,1477,4,4,0
South Dakota,Hot Springs,3477,9,7,2
South Dakota,Huron,13469,25,25,0
South Dakota,Jefferson,507,2,2,0
South Dakota,Kadoka,724,1,1,0
South Dakota,Kimball,670,1,1,0
South Dakota,Lead,2923,7,6,1
South Dakota,Lennox,2520,5,5,0
South Dakota,Madison,7357,14,13,1
South Dakota,Martin,1042,3,3,0
South Dakota,Menno,615,1,1,0
South Dakota,Milbank,3077,7,7,0
South Dakota,Miller,1318,4,4,0
South Dakota,Mitchell,15726,23,21,2
South Dakota,Mobridge,3442,16,8,8
South Dakota,Murdo,432,2,2,0
South Dakota,North Sioux City,2975,9,8,1
South Dakota,Parkston,1473,2,2,0
South Dakota,Philip,764,2,2,0
South Dakota,Pierre,13888,40,25,15
South Dakota,Platte,1261,2,2,0
South Dakota,Rapid City,78492,171,134,37
South Dakota,Scotland,800,2,2,0
South Dakota,Sioux Falls,187370,308,273,35
South Dakota,Sisseton,2392,7,7,0
South Dakota,Spearfish,11902,32,21,11
South Dakota,Springfield,1915,2,2,0
South Dakota,Sturgis,6955,18,15,3
South Dakota,Summerset,2769,4,4,0
South Dakota,Tea,6340,8,8,0
South Dakota,Tripp,621,1,1,0
South Dakota,Tyndall,1017,2,2,0
South Dakota,Vermillion,10969,20,19,1
South Dakota,Wagner,1544,6,6,0
South Dakota,Watertown,22248,54,36,18
South Dakota,Webster,1709,5,5,0
South Dakota,Whitewood,984,5,4,1
South Dakota,Winner,2813,12,12,0
South Dakota,Yankton,14712,31,30,1
Tennessee,Adamsville,2161,8,7,1
Tennessee,Alamo,2268,4,4,0
Tennessee,Alcoa,10174,54,46,8
Tennessee,Alexandria,1017,4,3,1
Tennessee,Algood,4584,15,15,0
Tennessee,Ardmore,1221,9,5,4
Tennessee,Ashland City,4785,18,16,2
Tennessee,Athens,14059,33,31,2
Tennessee,Atoka,9632,23,22,1
Tennessee,Baileyton,454,3,3,0
Tennessee,Bartlett,59714,158,121,37
Tennessee,Baxter,1551,7,7,0
Tennessee,Bean Station,3098,7,6,1
Tennessee,Belle Meade,2854,21,15,6
Tennessee,Bells,2439,3,3,0
Tennessee,Benton,1268,7,6,1
Tennessee,Berry Hill,505,18,14,4
Tennessee,Big Sandy,519,1,1,0
Tennessee,Blaine,1861,4,4,0
Tennessee,Bluff City,1667,8,8,0
Tennessee,Bolivar,4892,27,24,3
Tennessee,Bradford,970,4,4,0
Tennessee,Brentwood,43454,80,63,17
Tennessee,Brighton,2911,7,7,0
Tennessee,Bristol,27013,88,69,19
Tennessee,Brownsville,9340,39,35,4
Tennessee,Bruceton,1387,2,2,0
Tennessee,Burns,1467,1,1,0
Tennessee,Calhoun,501,3,3,0
Tennessee,Camden,3637,18,13,5
Tennessee,Carthage,2343,12,8,4
Tennessee,Caryville,2130,6,6,0
Tennessee,Celina,1412,8,6,2
Tennessee,Centerville,3533,18,15,3
Tennessee,Chapel Hill,1548,7,6,1
Tennessee,Charleston,703,2,2,0
Tennessee,Chattanooga,184211,573,470,103
Tennessee,Church Hill,6655,10,9,1
Tennessee,Clarksville,161167,368,304,64
Tennessee,Cleveland,45994,124,105,19
Tennessee,Clifton,2651,5,5,0
Tennessee,Clinton,10111,43,33,10
Tennessee,Collegedale,11750,25,24,1
Tennessee,Collierville,51677,140,107,33
Tennessee,Collinwood,940,4,4,0
Tennessee,Columbia,41013,94,83,11
Tennessee,Cookeville,35119,93,72,21
Tennessee,Coopertown,4621,5,4,1
Tennessee,Cornersville,1307,2,2,0
Tennessee,Covington,8818,33,32,1
Tennessee,Cowan,1650,3,3,0
Tennessee,Cross Plains,1841,1,1,0
Tennessee,Crossville,11885,45,42,3
Tennessee,Cumberland City,306,2,2,0
Tennessee,Dandridge,3229,12,11,1
Tennessee,Dayton,7367,18,18,0
Tennessee,Decatur,1668,6,6,0
Tennessee,Decaturville,862,1,1,0
Tennessee,Decherd,2374,13,12,1
Tennessee,Dickson,15680,66,59,7
Tennessee,Dover,1562,5,5,0
Tennessee,Dresden,2921,9,8,1
Tennessee,Dunlap,5214,13,12,1
Tennessee,Dyer,2195,7,6,1
Tennessee,Dyersburg,16226,68,60,8
Tennessee,Eagleville,779,4,4,0
Tennessee,East Ridge,21202,48,44,4
Tennessee,Elizabethton,13432,46,42,4
Tennessee,Elkton,522,2,2,0
Tennessee,Englewood,1535,6,5,1
Tennessee,Erin,1274,5,4,1
Tennessee,Erwin,5901,17,16,1
Tennessee,Estill Springs,2035,6,6,0
Tennessee,Ethridge,488,5,4,1
Tennessee,Etowah,3495,13,12,1
Tennessee,Fairview,9300,22,22,0
Tennessee,Fayetteville,7077,29,27,2
Tennessee,Franklin,85722,135,123,12
Tennessee,Friendship,662,1,1,0
Tennessee,Gainesboro,960,6,3,3
Tennessee,Gallatin,44584,97,86,11
Tennessee,Gallaway,644,2,1,1
Tennessee,Gatlinburg,3846,47,45,2
Tennessee,Germantown,39264,130,107,23
Tennessee,Gibson,383,3,2,1
Tennessee,Gleason,1368,5,5,0
Tennessee,Goodlettsville,16896,55,41,14
Tennessee,Gordonsville,1249,7,6,1
Tennessee,Grand Junction,267,3,3,0
Tennessee,Graysville,1587,4,4,0
Tennessee,Greenbrier,6896,16,15,1
Tennessee,Greeneville,14875,56,54,2
Tennessee,Greenfield,2074,7,6,1
Tennessee,Halls,2047,8,8,0
Tennessee,Harriman,6110,20,19,1
Tennessee,Henderson,6361,16,16,0
Tennessee,Hendersonville,58901,141,125,16
Tennessee,Henry,448,1,1,0
Tennessee,Hohenwald,3822,17,16,1
Tennessee,Hollow Rock,677,2,1,1
Tennessee,Hornbeak,467,1,1,0
Tennessee,Humboldt,8116,31,26,5
Tennessee,Huntingdon,3818,17,13,4
Tennessee,Huntland,841,4,4,0
Tennessee,Jacksboro,2060,6,5,1
Tennessee,Jackson,67234,239,202,37
Tennessee,Jamestown,2123,9,9,0
Tennessee,Jasper,3459,8,8,0
Tennessee,Jefferson City,8188,31,29,2
Tennessee,Jellico,2148,4,3,1
Tennessee,Johnson City,67293,168,139,29
Tennessee,Jonesborough,5675,23,18,5
Tennessee,Kenton,1185,2,2,0
Tennessee,Kimball,1452,9,9,0
Tennessee,Kingsport,54260,152,112,40
Tennessee,Kingston,5998,13,12,1
Tennessee,Kingston Springs,2726,8,7,1
Tennessee,Knoxville,188672,495,371,124
Tennessee,Lafayette,5428,23,16,7
Tennessee,La Follette,6606,27,21,6
Tennessee,La Vergne,36067,73,58,15
Tennessee,Lawrenceburg,11093,39,34,5
Tennessee,Lebanon,37832,128,100,28
Tennessee,Lenoir City,9404,29,27,2
Tennessee,Lewisburg,12515,31,30,1
Tennessee,Lexington,7915,34,28,6
Tennessee,Livingston,4046,23,18,5
Tennessee,Lookout Mountain,1892,21,16,5
Tennessee,Loretto,1780,5,5,0
Tennessee,Loudon,5953,16,15,1
Tennessee,Madisonville,5031,21,18,3
Tennessee,Manchester,11145,38,34,4
Tennessee,Martin,10380,37,27,10
Tennessee,Maryville,30006,63,57,6
Tennessee,Mason,1525,4,4,0
Tennessee,Maynardville,2435,4,4,0
Tennessee,McEwen,1731,5,5,0
Tennessee,McKenzie,5323,21,16,5
Tennessee,McMinnville,13783,40,36,4
Tennessee,Medina,4365,10,9,1
Tennessee,Memphis,650937,2563,2064,499
Tennessee,Metropolitan Nashville Police Department,688013,1917,1419,498
Tennessee,Middleton,627,3,3,0
Tennessee,Milan,7585,33,26,7
Tennessee,Millersville,6811,13,11,2
Tennessee,Millington,10626,39,31,8
Tennessee,Minor Hill,532,2,2,0
Tennessee,Monteagle,1231,7,6,1
Tennessee,Monterey,2906,10,9,1
Tennessee,Morristown,30330,86,81,5
Tennessee,Moscow,553,4,4,0
Tennessee,Mountain City,2429,9,9,0
Tennessee,Mount Carmel,5284,9,8,1
Tennessee,Mount Juliet,38685,79,63,16
Tennessee,Mount Pleasant,4934,20,14,6
Tennessee,Munford,6134,18,18,0
Tennessee,Murfreesboro,151769,324,265,59
Tennessee,Newbern,3289,11,11,0
Tennessee,New Johnsonville,1868,6,5,1
Tennessee,New Market,1379,5,4,1
Tennessee,Newport,6880,32,28,4
Tennessee,New Tazewell,2707,10,10,0
Tennessee,Niota,735,3,2,1
Tennessee,Nolensville,10665,15,14,1
Tennessee,Norris,1603,5,5,0
Tennessee,Oakland,8558,21,19,2
Tennessee,Oak Ridge,29139,82,64,18
Tennessee,Obion,1032,2,2,0
Tennessee,Oliver Springs,3416,14,10,4
Tennessee,Oneida,3696,15,10,5
Tennessee,Paris,10047,39,27,12
Tennessee,Parsons,2283,8,8,0
Tennessee,Petersburg,571,1,1,0
Tennessee,Pigeon Forge,6311,76,58,18
Tennessee,Pikeville,1756,3,3,0
Tennessee,Piperton,2057,8,8,0
Tennessee,Pittman Center,578,4,4,0
Tennessee,Plainview,2160,2,2,0
Tennessee,Pleasant View,4874,8,8,0
Tennessee,Portland,13208,36,32,4
Tennessee,Pulaski,7571,26,23,3
Tennessee,Puryear,662,1,1,0
Tennessee,Red Bank,11861,25,23,2
Tennessee,Red Boiling Springs,1135,4,4,0
Tennessee,Ridgely,1605,5,3,2
Tennessee,Ripley,7686,32,26,6
Tennessee,Rockwood,5410,15,14,1
Tennessee,Rocky Top,1774,9,6,3
Tennessee,Rogersville,4368,18,13,5
Tennessee,Rossville,1003,7,7,0
Tennessee,Rutherford,1058,5,4,1
Tennessee,Rutledge,1362,3,3,0
Tennessee,Savannah,6928,23,21,2
Tennessee,Scotts Hill,978,3,3,0
Tennessee,Selmer,4289,19,17,2
Tennessee,Sevierville,17395,76,60,16
Tennessee,Sharon,911,2,1,1
Tennessee,Shelbyville,22306,55,45,10
Tennessee,Signal Mountain,8644,17,15,2
Tennessee,Smithville,4929,15,14,1
Tennessee,Smyrna,52984,109,86,23
Tennessee,Soddy-Daisy,13697,35,28,7
Tennessee,Somerville,3282,12,11,1
Tennessee,South Carthage,1408,4,4,0
Tennessee,South Fulton,2195,9,8,1
Tennessee,South Pittsburg,3022,8,8,0
Tennessee,Sparta,4960,15,13,2
Tennessee,Spencer,1700,2,2,0
Tennessee,Spring City,1850,8,7,1
Tennessee,Springfield,17372,41,37,4
Tennessee,Spring Hill,45765,64,60,4
Tennessee,St. Joseph,833,1,1,0
Tennessee,Surgoinsville,1755,1,1,0
Tennessee,Sweetwater,5904,20,19,1
Tennessee,Tazewell,2281,7,7,0
Tennessee,Tellico Plains,915,5,5,0
Tennessee,Tiptonville,3920,7,7,0
Tennessee,Townsend,467,4,4,0
Tennessee,Tracy City,1391,4,4,0
Tennessee,Trenton,4168,20,14,6
Tennessee,Trimble,609,1,1,0
Tennessee,Troy,1313,5,5,0
Tennessee,Tullahoma,19664,34,29,5
Tennessee,Tusculum,2692,2,2,0
Tennessee,Unicoi,3592,4,4,0
Tennessee,Union City,10263,40,30,10
Tennessee,Vonore,1559,9,9,0
Tennessee,Wartburg,924,6,6,0
Tennessee,Wartrace,700,2,1,1
Tennessee,Watertown,1528,6,6,0
Tennessee,Waverly,4154,14,13,1
Tennessee,Waynesboro,2417,7,7,0
Tennessee,Westmoreland,2421,10,8,2
Tennessee,White Bluff,3706,5,5,0
Tennessee,White House,12936,26,23,3
Tennessee,White Pine,2353,11,10,1
Tennessee,Whiteville,4436,8,7,1
Tennessee,Whitwell,1731,5,5,0
Tennessee,Winchester,9029,25,23,2
Tennessee,Woodbury,2919,10,10,0
Texas,Abernathy,2694,5,5,0
Texas,Abilene,124061,275,211,64
Texas,Addison,16778,71,60,11
Texas,Alamo,20078,46,34,12
Texas,Alamo Heights,8807,34,21,13
Texas,Alba,550,2,2,0
Texas,Alice,18634,36,27,9
Texas,Allen,108218,207,144,63
Texas,Alpine,5978,20,12,8
Texas,Alton,18632,28,22,6
Texas,Alvarado,4626,19,17,2
Texas,Alvin,27015,78,50,28
Texas,Amarillo,200296,416,354,62
Texas,Andrews,14487,19,18,1
Texas,Angleton,19500,51,35,16
Texas,Anna,16036,20,19,1
Texas,Anthony,5389,17,16,1
Texas,Aransas Pass,8414,42,28,14
Texas,Archer City,1687,2,2,0
Texas,Arcola,2811,8,8,0
Texas,Argyle,4527,14,12,2
Texas,Arlington,402700,876,682,194
Texas,Arp,1037,8,7,1
Texas,Athens,12757,32,24,8
Texas,Atlanta,5451,16,11,5
Texas,Aubrey,5274,15,15,0
Texas,Austin,1000276,2290,1738,552
Texas,Azle,13660,41,30,11
Texas,Baird,1485,2,2,0
Texas,Balch Springs,25189,53,36,17
Texas,Balcones Heights,3362,25,17,8
Texas,Ballinger,3629,9,7,2
Texas,Bangs,1518,3,3,0
Texas,Bartonville,1810,5,5,0
Texas,Bastrop,9479,25,21,4
Texas,Bay City,17505,57,35,22
Texas,Bayou Vista,1644,6,6,0
Texas,Baytown,77823,217,164,53
Texas,Beaumont,116766,320,261,59
Texas,Bedford,49274,125,76,49
Texas,Bee Cave,7255,20,19,1
Texas,Beeville,12788,31,23,8
Texas,Bellaire,19210,57,41,16
Texas,Bellmead,10835,28,18,10
Texas,Bells,1528,4,4,0
Texas,Bellville,4233,12,11,1
Texas,Belton,23435,48,35,13
Texas,Benbrook,23766,51,40,11
Texas,Bertram,1491,6,6,0
Texas,Beverly Hills,1984,13,7,6
Texas,Big Sandy,1418,4,4,0
Texas,Big Spring,28294,49,38,11
Texas,Bishop,3048,10,6,4
Texas,Blanco,2103,10,9,1
Texas,Blue Mound,2450,13,8,5
Texas,Boerne,19342,62,42,20
Texas,Bogata,1053,5,5,0
Texas,Bonham,10416,29,20,9
Texas,Borger,12318,29,27,2
Texas,Bovina,1768,3,3,0
Texas,Bowie,5103,21,15,6
Texas,Boyd,1557,6,6,0
Texas,Brady,5280,12,11,1
Texas,Brazoria,3059,12,8,4
Texas,Breckenridge,5386,18,12,6
Texas,Bremond,971,3,3,0
Texas,Brenham,18106,42,37,5
Texas,Bridge City,7864,22,16,6
Texas,Bridgeport,6732,24,15,9
Texas,Brookshire,5948,23,18,5
Texas,Brookside Village,1583,4,4,0
Texas,Brownfield,9324,29,24,5
Texas,Brownsboro,1309,4,4,0
Texas,Brownsville,183627,312,225,87
Texas,Brownwood,18367,61,38,23
Texas,Bryan,87435,183,153,30
Texas,Buda,18531,25,22,3
Texas,Bullard,3900,12,11,1
Texas,Bulverde,5370,17,16,1
Texas,Burkburnett,11321,23,17,6
Texas,Burleson,49660,90,65,25
Texas,Burnet,6455,21,19,2
Texas,Cactus,3250,12,9,3
Texas,Caddo Mills,1739,7,7,0
Texas,Caldwell,4403,11,10,1
Texas,Cameron,5458,14,10,4
Texas,Canton,3895,20,15,5
Texas,Canyon,16263,29,26,3
Texas,Carrollton,141745,222,169,53
Texas,Carthage,6395,21,15,6
Texas,Castroville,3159,9,8,1
Texas,Cedar Hill,48352,91,70,21
Texas,Cedar Park,82653,130,94,36
Texas,Celina,18165,33,30,3
Texas,Center,5157,30,22,8
Texas,Chandler,3233,8,8,0
Texas,Childress,6039,11,10,1
Texas,Chillicothe,669,1,1,0
Texas,Cibolo,32777,41,37,4
Texas,Cisco,3774,10,8,2
Texas,Clarksville,3042,5,5,0
Texas,Cleburne,31486,68,52,16
Texas,Cleveland,8285,30,20,10
Texas,Clifton,3446,8,7,1
Texas,Clint,1137,3,3,0
Texas,Clute,11742,39,26,13
Texas,Clyde,3838,10,9,1
Texas,Coleman,4230,8,8,0
Texas,College Station,120831,201,142,59
Texas,Colleyville,27602,48,43,5
Texas,Collinsville,2000,4,4,0
Texas,Colorado City,3827,10,6,4
Texas,Comanche,4183,12,11,1
Texas,Combes,3002,7,7,0
Texas,Commerce,9876,20,16,4
Texas,Conroe,94451,186,142,44
Texas,Coppell,41807,68,59,9
Texas,Copperas Cove,33333,68,50,18
Texas,Corinth,22367,37,32,5
Texas,Corpus Christi,329050,626,425,201
Texas,Corsicana,23914,53,39,14
Texas,Crandall,4147,16,16,0
Texas,Crane,3722,14,8,6
Texas,Crockett,6327,17,15,2
Texas,Crosbyton,1599,3,3,0
Texas,Crowley,16909,38,24,14
Texas,Crystal City,7158,17,10,7
Texas,Cuero,8237,15,14,1
Texas,Cumby,800,5,5,0
Texas,Cuney,140,1,1,0
Texas,Daingerfield,2362,7,6,1
Texas,Dalhart,8349,19,15,4
Texas,Dallas,1363028,3646,3137,509
Texas,Dalworthington Gardens,2382,17,12,5
Texas,Danbury,1765,1,1,0
Texas,Dawson,800,2,2,0
Texas,Dayton,8510,28,19,9
Texas,Decatur,7220,34,29,5
Texas,Deer Park,33631,94,63,31
Texas,De Kalb,1584,4,4,0
Texas,De Leon,2193,4,4,0
Texas,Del Rio,35733,77,54,23
Texas,Denison,25858,68,52,16
Texas,Denton,144569,229,185,44
Texas,Denver City,4964,16,10,6
Texas,DeSoto,53515,97,68,29
Texas,Devine,4883,14,11,3
Texas,Diboll,5182,17,12,5
Texas,Dickinson,21364,46,30,16
Texas,Dilley,4559,13,12,1
Texas,Dimmitt,4065,7,5,2
Texas,Donna,16400,48,35,13
Texas,Double Oak,3089,8,8,0
Texas,Dublin,3546,9,8,1
Texas,Dumas,13729,30,23,7
Texas,Duncanville,38847,71,61,10
Texas,Eagle Lake,3793,9,8,1
Texas,Early,3205,10,8,2
Texas,Eastland,3836,13,11,2
Texas,Edinburg,103491,215,156,59
Texas,Edna,5813,10,8,2
Texas,El Campo,11523,41,27,14
Texas,Electra,2723,13,8,5
Texas,Elgin,10567,26,22,4
Texas,El Paso,685288,1455,1189,266
Texas,Elsa,7274,24,18,6
Texas,Emory,1368,5,4,1
Texas,Encinal,595,2,2,0
Texas,Ennis,20557,44,34,10
Texas,Euless,57881,137,89,48
Texas,Everman,6220,20,16,4
Texas,Fairfield,2885,14,10,4
Texas,Fair Oaks Ranch,10497,25,22,3
Texas,Falfurrias,4797,10,8,2
Texas,Farmers Branch,51078,99,76,23
Texas,Farmersville,3668,11,9,2
Texas,Fate,16917,21,19,2
Texas,Ferris,3042,15,10,5
Texas,Flatonia,1436,8,8,0
Texas,Floresville,8247,21,19,2
Texas,Flower Mound,80907,145,96,49
Texas,Floydada,2641,6,6,0
Texas,Forest Hill,13058,29,21,8
Texas,Forney,29366,46,31,15
Texas,Fort Stockton,8429,31,20,11
Texas,Fort Worth,929509,2085,1667,418
Texas,Franklin,1649,5,5,0
Texas,Frankston,1164,5,5,0
Texas,Fredericksburg,11604,38,31,7
Texas,Freeport,12144,47,32,15
Texas,Freer,2651,9,6,3
Texas,Friendswood,40795,80,58,22
Texas,Frisco,212626,310,212,98
Texas,Fulshear,14094,26,24,2
Texas,Fulton,1502,1,1,0
Texas,Gainesville,16986,55,41,14
Texas,Galena Park,10740,25,19,6
Texas,Galveston,50751,198,148,50
Texas,Ganado,2062,3,3,0
Texas,Garden Ridge,4235,12,11,1
Texas,Garland,241845,477,354,123
Texas,Gatesville,12394,33,21,12
Texas,Georgetown,84210,120,88,32
Texas,George West,2575,12,10,2
Texas,Giddings,5126,17,12,5
Texas,Gilmer,5171,19,15,4
Texas,Gladewater,6333,20,15,5
Texas,Glenn Heights,13662,22,15,7
Texas,Godley,1423,6,6,0
Texas,Gonzales,7568,26,18,8
Texas,Granbury,11080,48,42,6
Texas,Grand Prairie,196990,413,274,139
Texas,Grand Saline,3178,11,10,1
Texas,Granger,1514,2,2,0
Texas,Granite Shoals,5096,14,11,3
Texas,Grapevine,56343,147,93,54
Texas,Greenville,29209,69,50,19
Texas,Gregory,1886,7,7,0
Texas,Groesbeck,4244,9,9,0
Texas,Groves,15412,22,20,2
Texas,Gun Barrel City,6269,20,14,6
Texas,Gunter,1696,5,5,0
Texas,Hallettsville,2645,9,8,1
Texas,Hallsville,4382,6,6,0
Texas,Haltom City,44037,78,72,6
Texas,Hamilton,3005,8,7,1
Texas,Hamlin,2010,10,5,5
Texas,Harker Heights,33091,67,53,14
Texas,Harlingen,65014,169,125,44
Texas,Haskell,3136,6,5,1
Texas,Hawkins,1328,3,3,0
Texas,Hawley,622,2,2,0
Texas,Hearne,4345,18,12,6
Texas,Heath,9584,25,24,1
Texas,Hedwig Village,2643,23,17,6
Texas,Helotes,10301,31,30,1
Texas,Hemphill,1243,4,4,0
Texas,Hempstead,8699,21,17,4
Texas,Henderson,13093,41,33,8
Texas,Hewitt,15092,38,28,10
Texas,Hickory Creek,4979,12,12,0
Texas,Highland Park,9160,70,57,13
Texas,Highland Village,16848,42,29,13
Texas,Hillsboro,8480,34,25,9
Texas,Hitchcock,8023,18,16,2
Texas,Hollywood Park,3370,18,17,1
Texas,Hondo,9506,27,23,4
Texas,Honey Grove,1745,5,5,0
Texas,Hooks,2706,7,7,0
Texas,Horizon City,19973,41,23,18
Texas,Horseshoe Bay,4085,25,21,4
Texas,Houston,2346155,6223,5212,1011
Texas,Howe,3442,8,7,1
Texas,Hudson,5035,4,4,0
Texas,Hudson Oaks,2587,12,11,1
Texas,Hughes Springs,1704,4,4,0
Texas,Humble,15901,75,60,15
Texas,Huntington,2110,6,6,0
Texas,Huntsville,42648,68,59,9
Texas,Hurst,38796,119,71,48
Texas,Hutchins,5941,26,18,8
Texas,Hutto,29590,48,44,4
Texas,Idalou,2308,4,4,0
Texas,Indian Lake,883,3,3,0
Texas,Ingleside,10296,33,22,11
Texas,Ingram,1859,8,7,1
Texas,Iowa Colony,3686,9,9,0
Texas,Iowa Park,6334,17,10,7
Texas,Irving,242976,574,376,198
Texas,Italy,1928,8,7,1
Texas,Itasca,1743,6,6,0
Texas,Jacinto City,10455,26,20,6
Texas,Jacksboro,4372,11,10,1
Texas,Jacksonville,14843,44,29,15
Texas,Jamaica Beach,1089,6,6,0
Texas,Jarrell,1953,6,6,0
Texas,Jasper,7543,28,21,7
Texas,Jefferson,1896,7,5,2
Texas,Jersey Village,7921,26,24,2
Texas,Jones Creek,2079,5,5,0
Texas,Jonestown,2139,10,9,1
Texas,Josephine,2182,5,5,0
Texas,Joshua,8319,13,11,2
Texas,Jourdanton,4467,10,9,1
Texas,Junction,2387,9,7,2
Texas,Karnes City,3419,9,8,1
Texas,Katy,22797,82,66,16
Texas,Keller,48117,82,50,32
Texas,Kemah,2046,18,13,5
Texas,Kemp,1259,6,6,0
Texas,Kempner,1145,3,2,1
Texas,Kenedy,3357,15,14,1
Texas,Kennedale,8881,23,19,4
Texas,Kerens,1519,5,5,0
Texas,Kermit,6583,18,14,4
Texas,Kerrville,23912,65,46,19
Texas,Kilgore,15016,51,37,14
Texas,Killeen,154417,285,235,50
Texas,Kingsville,25195,71,45,26
Texas,Kirby,8805,23,17,6
Texas,Knox City,1118,2,2,0
Texas,Kountze,2104,7,6,1
Texas,Kress,677,1,1,0
Texas,Kyle,51306,82,53,29
Texas,Lacy-Lakeview,6748,20,12,8
Texas,La Feria,7232,20,15,5
Texas,Lago Vista,7740,25,18,7
Texas,La Grange,4680,13,12,1
Texas,La Grulla,1710,9,8,1
Texas,Laguna Vista,3183,9,9,0
Texas,La Joya,4326,17,12,5
Texas,Lake City,534,1,1,0
Texas,Lake Dallas,8174,16,13,3
Texas,Lake Jackson,27265,63,47,16
Texas,Lakeport,998,4,4,0
Texas,Lakeside,1603,7,7,0
Texas,"Lakeview, Harrison County",6231,14,13,1
Texas,Lake Worth,4921,33,26,7
Texas,La Marque,17656,39,32,7
Texas,Lamesa,9119,27,20,7
Texas,Lampasas,8132,32,22,10
Texas,Lancaster,39587,63,59,4
Texas,La Porte,35102,103,79,24
Texas,Laredo,265515,602,509,93
Texas,La Vernia,1481,9,9,0
Texas,League City,110518,163,116,47
Texas,Leander,68571,84,64,20
Texas,Leon Valley,12453,50,46,4
Texas,Levelland,13502,35,24,11
Texas,Lewisville,110800,219,165,54
Texas,Liberty,9418,26,15,11
Texas,Liberty Hill,3345,15,14,1
Texas,Lindale,6675,25,17,8
Texas,Linden,1908,6,5,1
Texas,Little Elm,57482,81,73,8
Texas,Live Oak,16910,45,34,11
Texas,Livingston,5240,29,22,7
Texas,Log Cabin,779,4,4,0
Texas,Lone Star,1472,6,5,1
Texas,Longview,81751,214,170,44
Texas,Lorena,1762,10,8,2
Texas,Los Indios,1063,2,2,0
Texas,Lubbock,262146,557,446,111
Texas,Lufkin,35007,96,76,20
Texas,Lumberton,13195,21,18,3
Texas,Lyford,2531,3,3,0
Texas,Lytle,3135,9,8,1
Texas,Madisonville,4715,13,10,3
Texas,Magnolia,2193,16,14,2
Texas,Manor,15569,32,27,5
Texas,Mansfield,74360,158,103,55
Texas,Manvel,13971,28,22,6
Texas,Marble Falls,7157,35,22,13
Texas,Marfa,1589,5,5,0
Texas,Marion,1262,3,3,0
Texas,Marlin,5539,14,10,4
Texas,Marshall,22755,65,49,16
Texas,Mathis,4694,13,9,4
Texas,McAllen,144569,428,286,142
Texas,McGregor,5368,16,10,6
Texas,McKinney,208335,287,218,69
Texas,Meadows Place,4587,17,16,1
Texas,Melissa,13424,14,14,0
Texas,Memorial Villages,12375,46,33,13
Texas,Mercedes,16699,41,33,8
Texas,Merkel,2620,6,5,1
Texas,Mesquite,141325,319,227,92
Texas,Mexia,7329,18,16,2
Texas,Midland,150529,243,152,91
Texas,Midlothian,34962,95,66,29
Texas,Milford,749,3,3,0
Texas,Mineola,4797,19,12,7
Texas,Mineral Wells,15057,46,33,13
Texas,Mission,85052,203,159,44
Texas,Missouri City,76476,130,102,28
Texas,Monahans,7924,20,15,5
Texas,Mont Belvieu,6954,25,16,9
Texas,Montgomery,1488,13,12,1
Texas,Morgans Point Resort,4738,9,9,0
Texas,Moulton,901,4,4,0
Texas,Mount Pleasant,15974,46,33,13
Texas,Muleshoe,5005,13,7,6
Texas,Murphy,20798,35,24,11
Texas,Mustang Ridge,999,5,5,0
Texas,Nacogdoches,32873,86,57,29
Texas,Naples,1307,3,3,0
Texas,Nash,3938,9,9,0
Texas,Nassau Bay,3968,15,14,1
Texas,Natalia,1610,4,4,0
Texas,Navasota,8104,27,19,8
Texas,Nederland,17413,41,27,14
Texas,New Boston,4588,19,14,5
Texas,New Braunfels,94751,172,137,35
Texas,Newton,2359,4,4,0
Texas,Nixon,2560,7,7,0
Texas,Nocona,2999,6,5,1
Texas,Nolanville,6048,11,10,1
Texas,Northeast,3485,13,12,1
Texas,Northlake,3582,18,16,2
Texas,North Richland Hills,71520,187,113,74
Texas,Oak Ridge,256,3,1,2
Texas,Oak Ridge North,3171,17,17,0
Texas,Odessa,126288,198,137,61
Texas,Olmos Park,2492,14,13,1
Texas,Olney,3080,9,7,2
Texas,Omaha,975,3,3,0
Texas,Onalaska,3006,8,8,0
Texas,Orange,18064,58,42,16
Texas,Ore City,1238,4,4,0
Texas,Overton,2498,9,6,3
Texas,Ovilla,4247,11,10,1
Texas,Oyster Creek,1203,12,9,3
Texas,Palacios,4516,13,9,4
Texas,Palestine,17625,43,28,15
Texas,Palmer,2136,11,10,1
Texas,Palmhurst,2753,16,13,3
Texas,Palm Valley,1232,5,5,0
Texas,Pampa,16975,37,25,12
Texas,Panhandle,2298,4,4,0
Texas,Pantego,2533,16,11,5
Texas,Paris,24801,69,46,23
Texas,Parker,5364,12,11,1
Texas,Pasadena,151421,373,282,91
Texas,Patton Village,2228,8,8,0
Texas,Pearland,126111,235,174,61
Texas,Pearsall,10783,20,16,4
Texas,Pecos,10667,53,23,30
Texas,Pelican Bay,2064,9,8,1
Texas,Penitas,4756,20,18,2
Texas,Perryton,8486,22,13,9
Texas,Pflugerville,67559,121,85,36
Texas,Pharr,80098,162,125,37
Texas,Pilot Point,4582,11,11,0
Texas,Pinehurst,1963,8,6,2
Texas,Pineland,795,3,3,0
Texas,Pittsburg,4717,12,10,2
Texas,Plainview,19926,37,30,7
Texas,Plano,290786,557,380,177
Texas,Pleasanton,11006,30,23,7
Texas,Ponder,2521,7,6,1
Texas,Port Aransas,4362,28,19,9
Texas,Port Arthur,54257,151,116,35
Texas,Port Isabel,6244,21,16,5
Texas,Portland,17468,49,34,15
Texas,Port Lavaca,11817,23,17,6
Texas,Port Neches,12616,25,22,3
Texas,Poteet,3535,11,10,1
Texas,Pottsboro,2528,10,8,2
Texas,Prairie View,7126,13,12,1
Texas,Premont,2531,6,6,0
Texas,Presidio,3836,4,4,0
Texas,Primera,5250,10,9,1
Texas,Princeton,15031,27,25,2
Texas,Prosper,27250,50,37,13
Texas,Queen City,1432,5,5,0
Texas,Quitman,1854,7,7,0
Texas,Rancho Viejo,2462,8,8,0
Texas,Ranger,2469,4,3,1
Texas,Raymondville,10833,23,14,9
Texas,Red Oak,13801,31,28,3
Texas,Refugio,2718,9,7,2
Texas,"Reno, Lamar County",3364,6,5,1
Texas,"Reno, Parker County",3294,7,7,0
Texas,Richardson,124190,255,165,90
Texas,Richland Hills,7971,22,19,3
Texas,Richmond,12630,40,28,12
Texas,Richwood,4044,10,10,0
Texas,Riesel,1040,3,3,0
Texas,Rio Grande City,14587,45,33,12
Texas,Rio Hondo,2744,7,7,0
Texas,River Oaks,7653,22,16,6
Texas,Roanoke,9862,39,29,10
Texas,Robinson,12087,32,23,9
Texas,Robstown,11238,31,22,9
Texas,Rockdale,5503,15,10,5
Texas,Rockport,10672,34,27,7
Texas,Rockwall,46867,100,79,21
Texas,Rollingwood,1607,9,9,0
Texas,Roma,11559,34,26,8
Texas,Roman Forest,2058,11,10,1
Texas,Rosenberg,39162,107,83,24
Texas,Round Rock,137593,244,172,72
Texas,Rowlett,68810,127,92,35
Texas,Royse City,15388,25,21,4
Texas,Runaway Bay,1612,5,5,0
Texas,Rusk,5606,13,12,1
Texas,Sachse,26799,46,32,14
Texas,Saginaw,24822,51,39,12
Texas,Salado,2393,5,5,0
Texas,San Angelo,101860,198,165,33
Texas,San Antonio,1573189,3087,2379,708
Texas,San Benito,24237,50,41,9
Texas,San Diego,4196,6,5,1
Texas,San Elizario,9070,3,3,0
Texas,Sanger,8953,16,14,2
Texas,San Juan,37337,59,43,16
Texas,San Marcos,67432,150,109,41
Texas,Santa Fe,13577,29,22,7
Texas,Schertz,43315,97,61,36
Texas,Schulenburg,2920,9,8,1
Texas,Seabrook,14415,42,32,10
Texas,Seagoville,17120,36,26,10
Texas,Sealy,6484,26,23,3
Texas,Seguin,30513,79,57,22
Texas,Selma,12013,32,28,4
Texas,Seven Points,1532,10,6,4
Texas,Seymour,2532,7,4,3
Texas,Shallowater,2586,5,5,0
Texas,Shavano Park,4098,19,18,1
Texas,Shenandoah,3098,26,25,1
Texas,Sherman,44611,91,67,24
Texas,Silsbee,6613,23,17,6
Texas,Sinton,5324,12,11,1
Texas,Slaton,5864,19,13,6
Texas,Socorro,34626,58,36,22
Texas,Somerset,2000,4,4,0
Texas,Somerville,1475,3,2,1
Texas,Sonora,2765,7,5,2
Texas,Sour Lake,1937,7,5,2
Texas,South Houston,17485,44,31,13
Texas,Southlake,33083,78,70,8
Texas,South Padre Island,2772,37,27,10
Texas,Southside Place,1902,12,8,4
Texas,Splendora,2337,15,13,2
Texas,Springtown,3254,15,11,4
Texas,Spring Valley,4389,24,18,6
Texas,Spur,1186,3,2,1
Texas,Stafford,17423,71,54,17
Texas,Stamford,2921,7,6,1
Texas,Stanton,3061,6,6,0
Texas,Stephenville,21777,56,34,22
Texas,Stinnett,1759,4,4,0
Texas,Stratford,2062,3,2,1
Texas,Sugar Land,119671,194,166,28
Texas,Sullivan City,4186,16,10,6
Texas,Sulphur Springs,16322,39,28,11
Texas,Sunrise Beach Village,806,5,5,0
Texas,Sunset Valley,675,14,13,1
Texas,Surfside Beach,591,21,18,3
Texas,Sweeny,3716,8,8,0
Texas,Sweetwater,10419,31,25,6
Texas,Tatum,1384,6,6,0
Texas,Teague,3511,7,6,1
Texas,Temple,79878,185,146,39
Texas,Tenaha,1145,3,3,0
Texas,Terrell,19204,64,42,22
Texas,Terrell Hills,5512,17,17,0
Texas,Texarkana,36303,92,80,12
Texas,Texas City,50660,114,88,26
Texas,The Colony,45419,104,74,30
Texas,Thrall,993,2,2,0
Texas,Three Rivers,1960,10,9,1
Texas,Tioga,1081,4,4,0
Texas,Tomball,11901,61,43,18
Texas,Tool,2310,8,4,4
Texas,Trophy Club,13053,24,20,4
Texas,Tulia,4618,15,8,7
Texas,Tye,1345,7,6,1
Texas,Tyler,108139,230,185,45
Texas,Universal City,21162,37,27,10
Texas,University Park,25253,55,39,16
Texas,Uvalde,16027,55,39,16
Texas,Van,2753,10,10,0
Texas,Van Alstyne,4557,17,11,6
Texas,Venus,4570,13,13,0
Texas,Vernon,10253,28,21,7
Texas,Vidor,10370,31,21,10
Texas,Waco,140870,348,253,95
Texas,Waelder,1141,3,3,0
Texas,Wake Village,5309,10,9,1
Texas,Waller,3654,15,13,2
Texas,Wallis,1309,8,8,0
Texas,Watauga,24588,47,36,11
Texas,Waxahachie,39039,92,73,19
Texas,Weatherford,34522,82,63,19
Texas,Webster,11545,63,45,18
Texas,Weimar,2235,8,7,1
Texas,Weslaco,42184,100,76,24
Texas,West,3008,9,9,0
Texas,West Columbia,3823,20,13,7
Texas,West Lake Hills,3310,15,14,1
Texas,West Orange,3199,12,10,2
Texas,Westover Hills,688,16,11,5
Texas,West University Place,15700,33,24,9
Texas,Westworth,2790,18,13,5
Texas,Wharton,8612,35,25,10
Texas,Whitehouse,9047,16,15,1
Texas,White Oak,6303,20,16,4
Texas,White Settlement,18051,42,32,10
Texas,Whitewright,1734,4,4,0
Texas,Wichita Falls,104673,292,203,89
Texas,Willis,7166,21,19,2
Texas,Willow Park,6096,16,15,1
Texas,Wills Point,3667,9,8,1
Texas,Wilmer,4919,21,16,5
Texas,Windcrest,5930,37,26,11
Texas,Wink,1039,3,3,0
Texas,Winnsboro,3302,18,12,6
Texas,Wolfforth,5735,13,12,1
Texas,Woodsboro,1399,2,2,0
Texas,Woodville,2411,10,9,1
Texas,Woodway,9089,42,32,10
Texas,Wortham,988,4,4,0
Texas,Wylie,54460,77,64,13
Texas,Yoakum,5956,19,12,7
Utah,Alta,378,8,4,4
Utah,American Fork/Cedar Hills,44093,49,43,6
Utah,Aurora,1056,1,1,0
Utah,Big Water,515,1,1,0
Utah,Blanding,3663,6,5,1
Utah,Bluffdale,17826,14,14,0
Utah,Bountiful,44129,56,36,20
Utah,Brian Head,94,5,5,0
Utah,Brigham City,19792,33,27,6
Utah,Cedar City,35486,45,39,6
Utah,Centerville,17855,24,19,5
Utah,Clearfield,32358,43,31,12
Utah,Clinton,22725,20,18,2
Utah,Cottonwood Heights,33871,47,39,8
Utah,Draper,49326,60,44,16
Utah,East Carbon,1574,4,4,0
Utah,Enoch,7340,12,7,5
Utah,Ephraim,7450,8,7,1
Utah,Fairview,1371,1,1,0
Utah,Farmington,26256,26,23,3
Utah,Fountain Green,1177,1,1,0
Utah,Grantsville,12468,17,15,2
Utah,Harrisville,7029,11,10,1
Utah,Heber,17849,29,24,5
Utah,Helper,2094,5,4,1
Utah,Herriman,56312,42,37,5
Utah,Hildale,2911,13,10,3
Utah,Hurricane,19776,31,28,3
Utah,Kamas,2328,2,2,0
Utah,Kanab,4993,8,7,1
Utah,Kaysville,32959,35,32,3
Utah,La Verkin,4491,6,5,1
Utah,Layton,79240,114,83,31
Utah,Lehi,72654,61,56,5
Utah,Lindon,11218,17,15,2
Utah,Logan,51899,85,53,32
Utah,Lone Peak,30191,27,22,5
Utah,Mantua,1000,2,1,1
Utah,Mapleton,11068,11,10,1
Utah,Moab,5362,23,15,8
Utah,Moroni,1566,1,1,0
Utah,Mount Pleasant,3561,4,4,0
Utah,Murray,49169,90,76,14
Utah,Naples,2126,5,4,1
Utah,Nephi,6498,13,10,3
Utah,North Ogden,20960,26,20,6
Utah,North Park,16529,13,10,3
Utah,North Salt Lake,21540,29,23,6
Utah,Ogden,88309,166,129,37
Utah,Orem,98902,123,91,32
Utah,Park City,8632,37,32,5
Utah,Parowan,3208,6,6,0
Utah,Payson,20498,27,24,3
Utah,Perry,5335,8,7,1
Utah,Pleasant Grove,38803,32,28,4
Utah,Pleasant View,11212,11,10,1
Utah,Price,8291,18,15,3
Utah,Provo,117041,228,198,30
Utah,Richfield,7925,18,15,3
Utah,Riverdale,8876,22,19,3
Utah,Riverton,45095,39,35,4
Utah,Roosevelt,7359,13,12,1
Utah,Roy,39849,43,39,4
Utah,Salem,8902,12,11,1
Utah,Salina,2624,4,4,0
Utah,Salt Lake City,202187,644,523,121
Utah,Sandy,97091,142,110,32
Utah,Santa Clara/Ivins,18229,16,13,3
Utah,Santaquin/Genola,14933,14,12,2
Utah,Saratoga Springs,35623,30,26,4
Utah,Smithfield,12317,11,10,1
Utah,South Jordan,80090,65,60,5
Utah,South Ogden,17266,27,22,5
Utah,South Salt Lake,25816,77,64,13
Utah,Spanish Fork,41605,42,38,4
Utah,Spring City,1090,1,1,0
Utah,Springdale,641,9,8,1
Utah,Springville,33728,41,30,11
Utah,St. George,91673,163,115,48
Utah,Stockton,688,4,3,1
Utah,Sunset,5387,8,7,1
Utah,Syracuse,32343,26,24,2
Utah,Tooele,36527,44,37,7
Utah,Tremonton Garland,11995,17,15,2
Utah,Vernal,10606,22,20,2
Utah,Washington,30622,39,28,11
Utah,Wellington,1612,9,8,1
Utah,West Bountiful,5861,11,10,1
Utah,West Jordan,117955,146,121,25
Utah,West Valley,135887,262,217,45
Utah,Willard,1979,3,3,0
Utah,Woods Cross,11625,18,17,1
Vermont,Barre,8471,27,20,7
Vermont,Barre Town,7698,8,7,1
Vermont,Bellows Falls,2946,7,6,1
Vermont,Bennington,14879,33,25,8
Vermont,Berlin,2770,9,8,1
Vermont,Bradford,2691,2,2,0
Vermont,Brandon,3710,7,6,1
Vermont,Brattleboro,11256,33,21,12
Vermont,Brighton,1161,1,1,0
Vermont,Bristol,3835,3,3,0
Vermont,Burlington,42862,121,86,35
Vermont,Canaan,916,1,1,0
Vermont,Castleton,4490,5,5,0
Vermont,Chester,3011,6,5,1
Vermont,Colchester,17129,37,29,8
Vermont,Dover,1052,7,6,1
Vermont,Essex,22156,32,26,6
Vermont,Fair Haven,2536,4,4,0
Vermont,Hardwick,2846,9,9,0
Vermont,Hartford,9515,28,19,9
Vermont,Hinesburg,4540,10,5,5
Vermont,Killington,750,2,2,0
Vermont,Ludlow,1854,9,5,4
Vermont,Lyndonville,1160,3,3,0
Vermont,Manchester,4206,13,9,4
Vermont,Middlebury,8813,18,16,2
Vermont,Milton,10882,17,16,1
Vermont,Montpelier,7321,26,17,9
Vermont,Morristown,5532,10,10,0
Vermont,Newport,4222,16,12,4
Vermont,Northfield,6560,6,5,1
Vermont,Norwich,3409,5,4,1
Vermont,Pittsford,2766,1,1,0
Vermont,Richmond,4123,3,3,0
Vermont,Royalton,2881,2,2,0
Vermont,Rutland,14930,47,34,13
Vermont,Rutland Town,4117,4,4,0
Vermont,Shelburne,7706,19,11,8
Vermont,South Burlington,19690,47,39,8
Vermont,Springfield,8859,20,14,6
Vermont,St. Albans,6788,34,24,10
Vermont,St. Johnsbury,7112,17,11,6
Vermont,Stowe,4444,12,12,0
Vermont,Swanton,6569,7,6,1
Vermont,Thetford,2525,3,3,0
Vermont,Vergennes,2577,8,8,0
Vermont,Weathersfield,2727,2,2,0
Vermont,Williston,10247,21,16,5
Vermont,Wilmington,1787,8,6,2
Vermont,Windsor,3272,8,7,1
Vermont,Winhall,726,8,7,1
Vermont,Winooski,7341,18,14,4
Vermont,Woodstock,2907,7,6,1
Virginia,Abingdon,7828,27,24,3
Virginia,Alexandria,161525,423,314,109
Virginia,Altavista,3401,14,13,1
Virginia,Amherst,2174,6,6,0
Virginia,Ashland,7947,27,25,2
Virginia,Bedford,6601,25,21,4
Virginia,Berryville,4393,10,9,1
Virginia,Big Stone Gap,5080,14,13,1
Virginia,Blacksburg,44422,75,65,10
Virginia,Blackstone,3299,15,12,3
Virginia,Bluefield,4780,23,20,3
Virginia,Bowling Green,1182,1,1,0
Virginia,Bridgewater,6204,9,9,0
Virginia,Bristol,16640,67,50,17
Virginia,Broadway,4010,5,5,0
Virginia,Brookneal,1096,1,1,0
Virginia,Buena Vista,6459,17,16,1
Virginia,Burkeville,396,1,1,0
Virginia,Cape Charles,1020,10,10,0
Virginia,Cedar Bluff,989,4,4,0
Virginia,Charlottesville,47671,126,101,25
Virginia,Chase City,2201,10,9,1
Virginia,Chatham,1422,2,2,0
Virginia,Chesapeake,247118,514,371,143
Virginia,Chilhowie,1690,6,6,0
Virginia,Chincoteague,2868,14,10,4
Virginia,Christiansburg,22643,69,62,7
Virginia,Clarksville,1159,6,5,1
Virginia,Clifton Forge,3455,10,9,1
Virginia,Clintwood,1267,3,3,0
Virginia,Coeburn,1824,9,8,1
Virginia,Colonial Beach,3628,11,10,1
Virginia,Colonial Heights,17360,58,54,4
Virginia,Covington,5490,23,14,9
Virginia,Crewe,2109,6,5,1
Virginia,Culpeper,19131,49,41,8
Virginia,Damascus,772,4,4,0
Virginia,Danville,39704,131,116,15
Virginia,Dayton,1648,5,5,0
Virginia,Dublin,2590,8,7,1
Virginia,Dumfries,6038,11,10,1
Virginia,Eastville,337,4,4,0
Virginia,Elkton,2923,5,4,1
Virginia,Emporia,5282,37,26,11
Virginia,Exmore,1362,7,7,0
Virginia,Fairfax City,24161,83,59,24
Virginia,Falls Church,14877,48,32,16
Virginia,Farmville,7806,28,26,2
Virginia,Franklin,7896,24,17,7
Virginia,Fredericksburg,29592,86,64,22
Virginia,Front Royal,15387,51,37,14
Virginia,Galax,6275,37,24,13
Virginia,Gate City,1850,5,5,0
Virginia,Glade Spring,1400,2,2,0
Virginia,Glasgow,1102,1,1,0
Virginia,Glen Lyn,96,1,1,0
Virginia,Gordonsville,1641,7,7,0
Virginia,Gretna,1181,3,3,0
Virginia,Grottoes,2881,6,6,0
Virginia,Grundy,887,5,5,0
Virginia,Halifax,1203,5,5,0
Virginia,Hampton,134082,426,325,101
Virginia,Harrisonburg,53442,123,101,22
Virginia,Haymarket,1699,5,5,0
Virginia,Haysi,463,1,1,0
Virginia,Herndon,24739,39,26,13
Virginia,Hillsville,2654,16,15,1
Virginia,Honaker,1306,2,2,0
Virginia,Hopewell,22498,80,62,18
Virginia,Hurt,1215,2,2,0
Virginia,Independence,886,2,2,0
Virginia,Jonesville,919,3,3,0
Virginia,Kenbridge,1190,3,3,0
Virginia,Kilmarnock,1384,6,6,0
Virginia,La Crosse,572,1,1,0
Virginia,Lawrenceville,983,6,6,0
Virginia,Lebanon,3118,13,12,1
Virginia,Leesburg,55070,99,82,17
Virginia,Lexington,7487,19,16,3
Virginia,Louisa,1753,6,6,0
Virginia,Luray,4842,14,13,1
Virginia,Lynchburg,82871,197,157,40
Virginia,Manassas,41386,124,92,32
Virginia,Manassas Park,17839,36,28,8
Virginia,Marion,5515,22,21,1
Virginia,Martinsville,12417,50,45,5
Virginia,Middleburg,854,7,6,1
Virginia,Middletown,1411,5,4,1
Virginia,Mount Jackson,2126,6,6,0
Virginia,Narrows,1942,6,6,0
Virginia,New Market,2261,6,6,0
Virginia,Newport News,178896,623,449,174
Virginia,Norfolk,242516,807,656,151
Virginia,Norton,3975,23,16,7
Virginia,Occoquan,1104,2,2,0
Virginia,Onancock,1206,6,6,0
Virginia,Onley,498,5,5,0
Virginia,Orange,5140,17,15,2
Virginia,Parksley,804,1,1,0
Virginia,Pearisburg,2619,8,8,0
Virginia,Pembroke,1078,3,3,0
Virginia,Pennington Gap,1705,6,6,0
Virginia,Petersburg,31195,107,86,21
Virginia,Pocahontas,348,1,1,0
Virginia,Poquoson,12275,28,24,4
Virginia,Portsmouth,94205,249,199,50
Virginia,Pound,907,4,4,0
Virginia,Pulaski,8674,32,28,4
Virginia,Purcellville,10485,16,14,2
Virginia,Radford,18450,52,38,14
Virginia,Remington,665,1,1,0
Virginia,Rich Creek,738,1,1,0
Virginia,Richlands,5172,25,20,5
Virginia,Richmond,233350,1048,846,202
Virginia,Roanoke,99335,274,228,46
Virginia,Rocky Mount,4718,22,20,2
Virginia,Rural Retreat,1444,1,1,0
Virginia,Salem,25326,86,62,24
Virginia,Saltville,1885,7,7,0
Virginia,Shenandoah,2327,7,6,1
Virginia,Smithfield,8518,24,20,4
Virginia,South Boston,7528,29,27,2
Virginia,South Hill,4322,22,20,2
Virginia,Stanley,1672,5,5,0
Virginia,Staunton,25048,63,48,15
Virginia,Stephens City,2091,1,1,0
Virginia,St. Paul,840,6,6,0
Virginia,Strasburg,6703,19,18,1
Virginia,Suffolk,92881,233,178,55
Virginia,Tappahannock,2397,11,10,1
Virginia,Tazewell,4088,17,16,1
Virginia,Timberville,2710,6,6,0
Virginia,Victoria,1615,4,4,0
Virginia,Vienna,16570,49,39,10
Virginia,Vinton,8117,22,21,1
Virginia,Virginia Beach,450858,925,744,181
Virginia,Warrenton,10073,28,27,1
Virginia,Warsaw,1485,4,4,0
Virginia,Waverly,1932,12,7,5
Virginia,Waynesboro,22801,53,43,10
Virginia,Weber City,1200,5,4,1
Virginia,West Point,3250,10,9,1
Virginia,Williamsburg,15086,42,40,2
Virginia,Winchester,28279,98,73,25
Virginia,Windsor,2774,7,7,0
Virginia,Wintergreen,165,16,12,4
Virginia,Wise,4381,12,11,1
Virginia,Woodstock,5279,20,18,2
Virginia,Wytheville,7890,25,22,3
Washington,Aberdeen,16744,50,36,14
Washington,Airway Heights,10010,22,20,2
Washington,Algona,3228,9,7,2
Washington,Anacortes,17735,30,24,6
Washington,Arlington,20825,35,30,5
Washington,Asotin,1293,1,1,0
Washington,Auburn,82779,134,114,20
Washington,Bainbridge Island,25561,27,23,4
Washington,Battle Ground,21669,27,23,4
Washington,Bellevue,150548,213,173,40
Washington,Bellingham,93629,180,118,62
Washington,Black Diamond,4858,12,10,2
Washington,Blaine,5717,16,14,2
Washington,Bonney Lake,21584,38,31,7
Washington,Bothell,48323,95,67,28
Washington,Bremerton,41817,68,55,13
Washington,Brewster,2355,6,5,1
Washington,Brier,7055,8,7,1
Washington,Buckley,5663,12,10,2
Washington,Burien,51879,70,48,22
Washington,Burlington,9321,29,23,6
Washington,Camas,24979,33,29,4
Washington,Carnation,2345,2,2,0
Washington,Castle Rock,2319,5,4,1
Washington,Centralia,17867,38,27,11
Washington,Chehalis,7700,22,17,5
Washington,Cheney,12741,23,16,7
Washington,Chewelah,2685,6,5,1
Washington,Clarkston,7387,16,14,2
Washington,Cle Elum,3023,9,8,1
Washington,Clyde Hill,3432,10,9,1
Washington,Colfax,2881,3,3,0
Washington,College Place,9374,16,13,3
Washington,Colville,4845,11,9,2
Washington,Connell,5725,8,7,1
Washington,Cosmopolis,1664,6,5,1
Washington,Coulee Dam,1078,2,2,0
Washington,Covington,21613,25,19,6
Washington,Des Moines,32652,43,33,10
Washington,Dupont,9668,14,12,2
Washington,Duvall,8275,14,13,1
Washington,East Wenatchee,14336,22,19,3
Washington,Eatonville,3058,6,5,1
Washington,Edgewood,13553,14,13,1
Washington,Edmonds,42934,65,55,10
Washington,Ellensburg,21448,34,26,8
Washington,Elma,3357,10,8,2
Washington,Enumclaw,12315,34,19,15
Washington,Ephrata,8184,18,15,3
Washington,Everett,112439,238,197,41
Washington,Everson,4551,7,6,1
Washington,Federal Way,97071,160,129,31
Washington,Ferndale,15337,23,20,3
Washington,Fife,10301,38,29,9
Washington,Fircrest,6869,9,9,0
Washington,Forks,3918,8,4,4
Washington,Garfield,610,1,1,0
Washington,Gig Harbor,11216,20,18,2
Washington,Goldendale,3516,11,9,2
Washington,Grand Coulee,2054,8,8,0
Washington,Grandview,11099,22,19,3
Washington,Granger,3898,8,8,0
Washington,Hoquiam,8647,25,23,2
Washington,Issaquah,40659,56,34,22
Washington,Kalama,2852,8,7,1
Washington,Kelso,12476,31,27,4
Washington,Kenmore,23397,20,15,5
Washington,Kennewick,85526,114,99,15
Washington,Kent,133883,207,151,56
Washington,Kettle Falls,1641,5,4,1
Washington,Kirkland,94470,150,109,41
Washington,Kittitas,1513,3,3,0
Washington,La Center,3459,8,7,1
Washington,Lacey,53826,64,49,15
Washington,Lake Forest Park,13604,23,20,3
Washington,Lake Stevens,34600,41,33,8
Washington,Lakewood,61432,108,95,13
Washington,Langley,1155,3,3,0
Washington,Liberty Lake,11410,14,13,1
Washington,Long Beach,1508,7,6,1
Washington,Longview,38629,69,57,12
Washington,Lynden,15625,21,17,4
Washington,Lynnwood,39517,97,66,31
Washington,Mabton,2265,3,3,0
Washington,Maple Valley,27736,24,18,6
Washington,Marysville,71522,103,74,29
Washington,Mattawa,4790,6,5,1
Washington,McCleary,1777,5,5,0
Washington,Medina,3324,11,9,2
Washington,Mercer Island,26268,35,30,5
Washington,Mill Creek,21214,26,21,5
Washington,Milton,8413,13,13,0
Washington,Monroe,20065,41,31,10
Washington,Montesano,4059,8,7,1
Washington,Morton,1207,3,3,0
Washington,Moses Lake,24524,46,38,8
Washington,Mountlake Terrace,21504,35,27,8
Washington,Mount Vernon,36513,53,39,14
Washington,Moxee,4177,7,6,1
Washington,Mukilteo,21573,33,26,7
Washington,Napavine,2025,5,4,1
Washington,Newcastle,12523,14,11,3
Washington,Newport,2205,5,4,1
Washington,Normandy Park,6633,11,10,1
Washington,Oak Harbor,23721,39,28,11
Washington,Ocean Shores,6604,12,10,2
Washington,Odessa,892,2,2,0
Washington,Olympia,53571,105,72,33
Washington,Omak,4776,10,8,2
Washington,Oroville,1671,6,5,1
Washington,Orting,8848,11,9,2
Washington,Othello,8509,23,16,7
Washington,Pacific,7243,12,11,1
Washington,Palouse,1084,2,2,0
Washington,Pasco,76970,92,82,10
Washington,Port Angeles,20364,54,32,22
Washington,Port Orchard,14886,25,20,5
Washington,Port Townsend,9914,17,13,4
Washington,Poulsbo,11401,22,20,2
Washington,Prosser,6451,17,15,2
Washington,Pullman,35071,44,29,15
Washington,Puyallup,42974,86,65,21
Washington,Quincy,8183,28,21,7
Washington,Raymond,3009,7,6,1
Washington,Reardan,615,1,1,0
Washington,Redmond,74154,122,85,37
Washington,Renton,102856,153,120,33
Washington,Richland,59370,77,60,17
Washington,Ridgefield,9835,12,11,1
Washington,Ritzville,1651,4,4,0
Washington,Roy,827,2,2,0
Washington,Royal City,2247,3,3,0
Washington,Ruston,856,5,5,0
Washington,Sammamish,66878,39,31,8
Washington,SeaTac,29282,63,45,18
Washington,Seattle,771517,1900,1341,559
Washington,Sedro Woolley,12189,24,20,4
Washington,Selah,8170,17,14,3
Washington,Sequim,7768,24,20,4
Washington,Shelton,10749,22,19,3
Washington,Shoreline,57472,72,52,20
Washington,Snohomish,10269,19,17,2
Washington,Snoqualmie,13987,27,23,4
Washington,Soap Lake,1609,7,6,1
Washington,South Bend,1706,5,4,1
Washington,Spokane,223524,422,342,80
Washington,Spokane Valley,102366,130,106,24
Washington,Stanwood,7410,13,11,2
Washington,Steilacoom,6436,10,9,1
Washington,Sumas,1561,7,6,1
Washington,Sumner,10544,25,20,5
Washington,Sunnyside,16888,43,25,18
Washington,Tacoma,220123,383,341,42
Washington,Tenino,1886,5,4,1
Washington,Tieton,1323,2,2,0
Washington,Toledo,777,3,2,1
Washington,Toppenish,8792,16,11,5
Washington,Tukwila,20483,82,66,16
Washington,Tumwater,24493,40,33,7
Washington,Twisp,970,3,3,0
Washington,Union Gap,6206,19,16,3
Washington,University Place,34339,17,16,1
Washington,Vancouver,186440,264,218,46
Washington,Walla Walla,32944,77,47,30
Washington,Wapato,5003,9,7,2
Washington,Warden,2825,5,4,1
Washington,Washougal,16334,24,20,4
Washington,Wenatchee,34525,54,43,11
Washington,Westport,2102,8,7,1
Washington,West Richland,15464,24,20,4
Washington,White Salmon,2732,7,6,1
Washington,Winlock,1436,3,3,0
Washington,Winthrop,480,3,2,1
Washington,Woodinville,13547,19,15,4
Washington,Woodland,6612,12,10,2
Washington,Yakima,93862,173,133,40
Washington,Yelm,9799,17,15,2
Washington,Zillah,3152,9,8,1
West Virginia,Alderson,1119,4,4,0
West Virginia,Anmoore,729,2,2,0
West Virginia,Ansted,1294,2,2,0
West Virginia,Athens,883,1,1,0
West Virginia,Barboursville,4291,24,22,2
West Virginia,Barrackville,1277,1,1,0
West Virginia,Beckley,15762,62,46,16
West Virginia,Belington,1900,3,3,0
West Virginia,Belle,1112,3,3,0
West Virginia,Benwood,1262,9,6,3
West Virginia,Berkeley Springs,593,2,2,0
West Virginia,Bethlehem,2302,5,5,0
West Virginia,Bluefield,9543,33,28,5
West Virginia,Bradshaw,265,1,1,0
West Virginia,Bramwell,334,2,2,0
West Virginia,Bridgeport,8924,37,33,4
West Virginia,Buckhannon,5373,12,11,1
West Virginia,Burnsville,473,1,1,0
West Virginia,Cameron,833,2,2,0
West Virginia,Cedar Grove,898,1,1,0
West Virginia,Ceredo,1260,7,4,3
West Virginia,Chapmanville,1080,4,4,0
West Virginia,Charleston,46038,181,158,23
West Virginia,Charles Town,6123,19,16,3
West Virginia,Chesapeake,1399,2,2,0
West Virginia,Chester,2347,6,5,1
West Virginia,Clarksburg,15092,44,40,4
West Virginia,Clendenin,1087,5,5,0
West Virginia,Danville,593,2,2,0
West Virginia,Davy,329,1,1,0
West Virginia,Delbarton,489,2,2,0
West Virginia,Dunbar,7010,13,12,1
West Virginia,East Bank,860,1,1,0
West Virginia,Eleanor,1594,1,1,0
West Virginia,Elkins,6970,13,12,1
West Virginia,Fairmont,18352,38,33,5
West Virginia,Fairview,403,1,1,0
West Virginia,Fayetteville,2695,13,12,1
West Virginia,Follansbee,2682,7,7,0
West Virginia,Fort Gay,684,3,3,0
West Virginia,Gary,770,1,1,0
West Virginia,Gassaway,839,1,1,0
West Virginia,Gauley Bridge,547,1,1,0
West Virginia,Gilbert,381,2,2,0
West Virginia,Glen Dale,1355,6,6,0
West Virginia,Glenville,1422,2,1,1
West Virginia,Grafton,4963,9,8,1
West Virginia,Grant Town,592,1,1,0
West Virginia,Granville,3767,14,14,0
West Virginia,Hamlin,1038,3,2,1
West Virginia,Harpers Ferry/Bolivar,1301,3,2,1
West Virginia,Harrisville,1654,1,1,0
West Virginia,Hartford City,592,1,1,0
West Virginia,Hinton,2324,6,5,1
West Virginia,Huntington,44684,96,93,3
West Virginia,Hurricane,6446,20,18,2
West Virginia,Iaeger,236,1,1,0
West Virginia,Kenova,2931,14,10,4
West Virginia,Kermit,344,1,1,0
West Virginia,Keyser,4863,12,8,4
West Virginia,Kimball,149,1,1,0
West Virginia,Kingwood,3057,3,3,0
West Virginia,Lewisburg,3803,15,13,2
West Virginia,Logan,1439,11,8,3
West Virginia,Mabscott,1248,2,2,0
West Virginia,Madison,2631,8,7,1
West Virginia,Man,617,2,2,0
West Virginia,Mannington,2018,4,4,0
West Virginia,Marlinton,952,1,1,0
West Virginia,Marmet,1352,5,5,0
West Virginia,Martinsburg,17479,54,43,11
West Virginia,Mason,932,5,4,1
West Virginia,Masontown,537,2,1,1
West Virginia,Matewan,416,2,1,1
West Virginia,McMechen,1677,4,4,0
West Virginia,Milton,2547,11,10,1
West Virginia,Monongah,1161,1,1,0
West Virginia,Montgomery,1494,7,6,1
West Virginia,Moorefield,2403,10,9,1
West Virginia,Morgantown,30775,83,71,12
West Virginia,Moundsville,8175,20,16,4
West Virginia,Mount Hope,1260,4,3,1
West Virginia,Mullens,1299,3,3,0
West Virginia,New Cumberland,997,2,1,1
West Virginia,New Haven,1455,3,3,0
West Virginia,New Martinsville,5092,14,10,4
West Virginia,Nitro,6314,20,19,1
West Virginia,Nutter Fort,1502,5,5,0
West Virginia,Oak Hill,8017,20,16,4
West Virginia,Oceana,1185,4,4,0
West Virginia,Paden City,2306,5,4,1
West Virginia,Parkersburg,29096,82,74,8
West Virginia,Parsons,1383,1,1,0
West Virginia,Pennsboro,989,1,1,0
West Virginia,Petersburg,2684,1,1,0
West Virginia,Philippi,3293,6,6,0
West Virginia,Piedmont,794,1,1,0
West Virginia,Pineville,564,3,3,0
West Virginia,Point Pleasant,4032,7,7,0
West Virginia,Pratt,551,3,2,1
West Virginia,Princeton,5627,23,21,2
West Virginia,Rainelle,1524,2,1,1
West Virginia,Ranson,5341,19,17,2
West Virginia,Ravenswood,3621,12,10,2
West Virginia,Reedsville,606,1,1,0
West Virginia,Rhodell,159,2,1,1
West Virginia,Richwood,1834,3,3,0
West Virginia,Ripley,3151,12,11,1
West Virginia,Rivesville,900,1,1,0
West Virginia,Romney,1680,6,5,1
West Virginia,Ronceverte,1660,6,6,0
West Virginia,Rupert,888,1,1,0
West Virginia,Salem,1515,4,4,0
West Virginia,Shepherdstown,1887,6,5,1
West Virginia,Shinnston,2093,9,8,1
West Virginia,Sistersville,1275,4,4,0
West Virginia,Sophia,1220,5,5,0
West Virginia,South Charleston,11898,49,46,3
West Virginia,Spencer,2011,6,5,1
West Virginia,St. Albans,9802,27,24,3
West Virginia,Star City,1969,7,6,1
West Virginia,St. Marys,1763,5,4,1
West Virginia,Stonewood,1704,2,2,0
West Virginia,Summersville,3243,17,16,1
West Virginia,Sutton,987,1,1,0
West Virginia,Sylvester,134,1,1,0
West Virginia,Terra Alta,1501,2,2,0
West Virginia,Triadelphia,756,1,1,0
West Virginia,Vienna,10049,24,20,4
West Virginia,War,668,3,3,0
West Virginia,Wayne,1563,1,1,0
West Virginia,Webster Springs,652,5,4,1
West Virginia,Weirton,18111,38,34,4
West Virginia,Welch,1577,6,5,1
West Virginia,Wellsburg,2502,6,5,1
West Virginia,West Liberty,1418,1,1,0
West Virginia,West Logan,357,1,1,0
West Virginia,West Milford,604,2,2,0
West Virginia,Weston,3831,8,6,2
West Virginia,Westover,4192,13,12,1
West Virginia,West Union,796,1,1,0
West Virginia,Wheeling,26222,79,68,11
West Virginia,White Hall,667,5,5,0
West Virginia,White Sulphur Springs,2343,8,7,1
West Virginia,Whitesville,419,2,2,0
West Virginia,Williamson,2625,6,5,1
West Virginia,Williamstown,2864,8,7,1
West Virginia,Winfield,2357,5,5,0
Wisconsin,Adams,1884,3,3,0
Wisconsin,Albany,990,3,3,0
Wisconsin,Algoma,3035,5,5,0
Wisconsin,Altoona,8009,15,14,1
Wisconsin,Amery,2799,6,6,0
Wisconsin,Antigo,7719,18,15,3
Wisconsin,Appleton,74255,139,112,27
Wisconsin,Arcadia,3051,4,4,0
Wisconsin,Argyle,807,1,1,0
Wisconsin,Ashland,7804,40,19,21
Wisconsin,Ashwaubenon,17183,57,52,5
Wisconsin,Athens,1075,1,1,0
Wisconsin,Bangor,1452,3,3,0
Wisconsin,Baraboo,12175,34,29,5
Wisconsin,Barneveld,1253,1,1,0
Wisconsin,Barron,3308,6,6,0
Wisconsin,Bayfield,470,3,3,0
Wisconsin,Bayside,4322,13,13,0
Wisconsin,Beaver Dam,16426,36,32,4
Wisconsin,Belleville,2473,7,6,1
Wisconsin,Beloit,36921,79,69,10
Wisconsin,Beloit Town,7741,14,12,2
Wisconsin,Berlin,5369,11,10,1
Wisconsin,Big Bend,1487,3,3,0
Wisconsin,Birchwood,426,1,1,0
Wisconsin,Black River Falls,3449,6,5,1
Wisconsin,Blair,1340,2,2,0
Wisconsin,Blanchardville,787,1,1,0
Wisconsin,Bloomer,3500,8,7,1
Wisconsin,Bloomfield,6363,8,8,0
Wisconsin,Blue Mounds,1001,1,1,0
Wisconsin,Boscobel,3118,6,6,0
Wisconsin,Boyceville,1131,2,2,0
Wisconsin,Brillion,3067,8,8,0
Wisconsin,Brodhead,3242,12,8,4
Wisconsin,Brookfield,39252,101,85,16
Wisconsin,Brookfield Township,6564,15,14,1
Wisconsin,Brown Deer,11808,33,30,3
Wisconsin,Brownsville,584,1,1,0
Wisconsin,Burlington,11025,23,22,1
Wisconsin,Butler,1793,9,8,1
Wisconsin,Caledonia,25323,37,35,2
Wisconsin,Campbellsport,1807,2,2,0
Wisconsin,Campbell Township,4296,5,5,0
Wisconsin,Cashton,1113,1,1,0
Wisconsin,Cedarburg,11621,28,20,8
Wisconsin,Chenequa,606,10,8,2
Wisconsin,Chetek,2083,5,4,1
Wisconsin,Chilton,3851,16,8,8
Wisconsin,Chippewa Falls,14437,27,23,4
Wisconsin,Cleveland,1450,2,2,0
Wisconsin,Clinton,2139,10,5,5
Wisconsin,Clintonville,4372,15,11,4
Wisconsin,Colby-Abbotsford,4185,9,8,1
Wisconsin,Colfax,1157,2,2,0
Wisconsin,Columbus,5134,11,9,2
Wisconsin,Cornell,1401,3,3,0
Wisconsin,Cottage Grove,7233,15,13,2
Wisconsin,Crandon,1787,4,3,1
Wisconsin,Cross Plains,4362,7,6,1
Wisconsin,Cuba City,2023,4,4,0
Wisconsin,Cudahy,18064,42,32,10
Wisconsin,Cumberland,2096,7,7,0
Wisconsin,Darlington,2325,10,5,5
Wisconsin,Deforest,10901,21,18,3
Wisconsin,Delavan,9836,25,23,2
Wisconsin,Delavan Town,5337,13,12,1
Wisconsin,Durand,1786,4,4,0
Wisconsin,Eagle River,1615,7,6,1
Wisconsin,Eagle Village,2177,2,2,0
Wisconsin,East Troy,4313,8,8,0
Wisconsin,Eau Claire,69086,128,91,37
Wisconsin,Edgar,1438,1,1,0
Wisconsin,Edgerton,5655,11,10,1
Wisconsin,Eleva,664,1,1,0
Wisconsin,Elkhart Lake,1022,3,3,0
Wisconsin,Elkhorn,10014,17,15,2
Wisconsin,Elk Mound,882,2,1,1
Wisconsin,Ellsworth,3320,10,5,5
Wisconsin,Elm Grove,6160,23,16,7
Wisconsin,Elroy,1289,3,3,0
Wisconsin,Evansville,5489,11,10,1
Wisconsin,Everest Metropolitan,17361,33,29,4
Wisconsin,Fall Creek,1286,2,2,0
Wisconsin,Fall River,1744,2,2,0
Wisconsin,Fennimore,2449,12,6,6
Wisconsin,Fitchburg,31483,64,52,12
Wisconsin,Fond du Lac,43295,78,69,9
Wisconsin,Fontana,1747,8,7,1
Wisconsin,Fort Atkinson,12425,26,20,6
Wisconsin,Fox Lake,1442,4,3,1
Wisconsin,Fox Point,6522,18,17,1
Wisconsin,Fox Valley Metro,22737,28,26,2
Wisconsin,Franklin,35814,76,59,17
Wisconsin,Frederic,1084,2,2,0
Wisconsin,Galesville,1606,4,4,0
Wisconsin,Geneva Town,5045,8,7,1
Wisconsin,Genoa City,2978,7,6,1
Wisconsin,Germantown,20133,40,32,8
Wisconsin,Gillett,1285,3,3,0
Wisconsin,Gilman,390,1,1,0
Wisconsin,Glendale,12714,46,40,6
Wisconsin,Grafton,11738,27,21,6
Wisconsin,Grand Chute,23579,39,33,6
Wisconsin,Grand Rapids,7393,8,6,2
Wisconsin,Grantsburg,1275,3,3,0
Wisconsin,Green Bay,104649,219,181,38
Wisconsin,Greendale,14141,38,29,9
Wisconsin,Greenfield,37237,79,60,19
Wisconsin,Green Lake,968,6,3,3
Wisconsin,Hales Corners,7548,17,16,1
Wisconsin,Hammond,1882,4,3,1
Wisconsin,Hartford,15573,31,27,4
Wisconsin,Hartford Township,3561,1,1,0
Wisconsin,Hartland,9343,19,17,2
Wisconsin,Hazel Green,1216,2,2,0
Wisconsin,Highland,825,1,1,0
Wisconsin,Hobart-Lawrence,16178,13,12,1
Wisconsin,Holmen,10135,14,13,1
Wisconsin,Horicon,3644,8,7,1
Wisconsin,Hortonville,2936,7,6,1
Wisconsin,Hudson,14255,31,28,3
Wisconsin,Hurley,1425,7,6,1
Wisconsin,Independence,1299,3,3,0
Wisconsin,Iron Ridge,887,1,1,0
Wisconsin,Iron River,1135,3,3,0
Wisconsin,Jackson,7247,12,11,1
Wisconsin,Janesville,64682,114,103,11
Wisconsin,Jefferson,7986,17,14,3
Wisconsin,Juneau,2653,5,4,1
Wisconsin,Kaukauna,16357,27,26,1
Wisconsin,Kenosha,100005,212,199,13
Wisconsin,Kewaskum,4290,8,8,0
Wisconsin,Kewaunee,2838,6,6,0
Wisconsin,Kiel,3805,8,7,1
Wisconsin,Kohler,2053,9,8,1
Wisconsin,Kronenwetter,8181,9,8,1
Wisconsin,La Crosse,51211,119,99,20
Wisconsin,Ladysmith,3097,8,8,0
Wisconsin,La Farge,761,1,1,0
Wisconsin,Lake Delton,2994,46,21,25
Wisconsin,Lake Geneva,8157,34,25,9
Wisconsin,Lake Hallie,6777,11,10,1
Wisconsin,Lake Mills,6013,12,10,2
Wisconsin,Lancaster,3682,6,6,0
Wisconsin,Lena,537,1,1,0
Wisconsin,Linn Township,2405,6,6,0
Wisconsin,Lodi,3096,13,6,7
Wisconsin,Lomira,2453,5,4,1
Wisconsin,Luxemburg,2576,1,1,0
Wisconsin,Madison,262736,617,505,112
Wisconsin,Manawa,1262,3,3,0
Wisconsin,Manitowoc,32458,73,63,10
Wisconsin,Maple Bluff,1310,5,5,0
Wisconsin,Marathon City,1505,3,3,0
Wisconsin,Marinette,10497,28,24,4
Wisconsin,Marion,1170,4,4,0
Wisconsin,Markesan,1394,4,4,0
Wisconsin,Marshall Village,3998,10,9,1
Wisconsin,Marshfield,18403,47,39,8
Wisconsin,Mauston,4348,10,9,1
Wisconsin,Mayville,4862,9,8,1
Wisconsin,McFarland,9161,19,17,2
Wisconsin,Medford,4274,10,9,1
Wisconsin,Menasha,17910,38,31,7
Wisconsin,Menomonee Falls,38290,131,59,72
Wisconsin,Menomonie,16582,31,26,5
Wisconsin,Mequon,24527,49,38,11
Wisconsin,Merrill,8984,25,22,3
Wisconsin,Middleton,20322,48,38,10
Wisconsin,Milton,5636,13,11,2
Wisconsin,Milwaukee,589105,2190,1752,438
Wisconsin,Mineral Point,2461,6,6,0
Wisconsin,Minocqua,4422,15,10,5
Wisconsin,Mishicot,1383,3,3,0
Wisconsin,Mondovi,2542,4,4,0
Wisconsin,Monona,8245,26,21,5
Wisconsin,Monroe,10538,32,25,7
Wisconsin,Montello,1464,3,2,1
Wisconsin,Monticello,1200,3,3,0
Wisconsin,Mosinee,4080,8,7,1
Wisconsin,Mount Horeb,7579,13,13,0
Wisconsin,Mount Pleasant,27125,61,55,6
Wisconsin,Mukwonago,8137,22,15,7
Wisconsin,Mukwonago Town,8168,7,6,1
Wisconsin,Muscoda,1234,3,3,0
Wisconsin,Muskego,25237,44,34,10
Wisconsin,Neenah,26390,50,40,10
Wisconsin,Neillsville,2403,6,5,1
Wisconsin,Nekoosa,2405,7,7,0
Wisconsin,New Berlin,39703,80,66,14
Wisconsin,New Glarus,2148,4,4,0
Wisconsin,New Holstein,3088,7,6,1
Wisconsin,New Lisbon,2546,4,4,0
Wisconsin,New London,7070,19,17,2
Wisconsin,New Richmond,9535,19,18,1
Wisconsin,Niagara,1535,3,3,0
Wisconsin,North Fond du Lac,5089,11,9,2
Wisconsin,North Hudson,3815,6,5,1
Wisconsin,Norwalk,630,1,1,0
Wisconsin,Oak Creek,36502,116,61,55
Wisconsin,Oconomowoc,17116,30,23,7
Wisconsin,Oconomowoc Town,8743,12,11,1
Wisconsin,Oconto,4548,9,9,0
Wisconsin,Oconto Falls,2785,6,6,0
Wisconsin,Omro,3590,8,7,1
Wisconsin,Onalaska,19072,30,28,2
Wisconsin,Oregon,10718,21,18,3
Wisconsin,Osceola,2556,6,5,1
Wisconsin,Oshkosh,67080,108,94,14
Wisconsin,Osseo,1673,4,4,0
Wisconsin,Palmyra,1753,6,6,0
Wisconsin,Park Falls,2207,6,6,0
Wisconsin,Pepin,775,1,1,0
Wisconsin,Peshtigo,3329,6,6,0
Wisconsin,Pewaukee Village,8102,19,18,1
Wisconsin,Phillips,1322,5,5,0
Wisconsin,Pittsville,819,2,2,0
Wisconsin,Plainfield,833,1,1,0
Wisconsin,Platteville,12184,28,20,8
Wisconsin,Pleasant Prairie,21181,43,33,10
Wisconsin,Plover,13201,23,20,3
Wisconsin,Plymouth,8762,16,16,0
Wisconsin,Portage,10408,26,22,4
Wisconsin,Port Edwards,1757,3,3,0
Wisconsin,Port Washington,11982,24,19,5
Wisconsin,Poynette,2507,5,4,1
Wisconsin,Prairie du Chien,5539,13,12,1
Wisconsin,Prescott,4299,11,10,1
Wisconsin,Pulaski,3742,9,8,1
Wisconsin,Racine,76573,216,185,31
Wisconsin,Reedsburg,9549,28,22,6
Wisconsin,Rhinelander,7629,17,15,2
Wisconsin,Rice Lake,8526,18,18,0
Wisconsin,Richland Center,4918,13,11,2
Wisconsin,Rio,1038,4,2,2
Wisconsin,Ripon,7854,20,14,6
Wisconsin,Ripon Town,1380,1,1,0
Wisconsin,River Falls,16141,26,23,3
Wisconsin,River Hills,1571,11,11,0
Wisconsin,Rome Town,2755,7,7,0
Wisconsin,Rosendale,1028,1,1,0
Wisconsin,Rothschild,5268,14,12,2
Wisconsin,Sauk Prairie,4650,17,15,2
Wisconsin,Saukville,4431,14,12,2
Wisconsin,Seymour,3454,6,6,0
Wisconsin,Sharon,1552,5,4,1
Wisconsin,Shawano,8896,22,20,2
Wisconsin,Sheboygan,47814,101,82,19
Wisconsin,Sheboygan Falls,7938,17,15,2
Wisconsin,Shiocton,912,3,2,1
Wisconsin,Shorewood,13133,28,24,4
Wisconsin,Shorewood Hills,2058,9,7,2
Wisconsin,Shullsburg,1188,1,1,0
Wisconsin,Siren,771,4,3,1
Wisconsin,Slinger,5621,13,12,1
Wisconsin,Somerset,2951,6,5,1
Wisconsin,South Milwaukee,20626,39,33,6
Wisconsin,Sparta,9865,23,21,2
Wisconsin,Spencer,1874,4,4,0
Wisconsin,Spooner,2557,8,7,1
Wisconsin,Spring Green,1643,2,2,0
Wisconsin,Spring Valley,1348,2,2,0
Wisconsin,Stanley,3722,5,5,0
Wisconsin,St. Croix Falls,2037,7,6,1
Wisconsin,Stevens Point,25790,48,44,4
Wisconsin,St. Francis,9733,22,21,1
Wisconsin,Stoughton,13164,29,23,6
Wisconsin,Strum,1087,2,2,0
Wisconsin,Sturgeon Bay,8913,24,22,2
Wisconsin,Sturtevant,6659,13,12,1
Wisconsin,Summit,5087,11,11,0
Wisconsin,Sun Prairie,35272,76,55,21
Wisconsin,Superior,25845,59,54,5
Wisconsin,Theresa,1199,4,2,2
Wisconsin,Thiensville,3116,8,7,1
Wisconsin,Thorp,1610,3,3,0
Wisconsin,Three Lakes,2112,5,5,0
Wisconsin,Tomah,9418,22,20,2
Wisconsin,Tomahawk,3111,9,8,1
Wisconsin,Town of East Troy,4060,7,6,1
Wisconsin,Town of Madison,6920,14,13,1
Wisconsin,Trempealeau,1680,3,3,0
Wisconsin,Twin Lakes,6230,18,13,5
Wisconsin,Two Rivers,10970,28,25,3
Wisconsin,Verona,13548,27,25,2
Wisconsin,Viroqua,4407,11,9,2
Wisconsin,Walworth,2828,19,18,1
Wisconsin,Washburn,2028,5,5,0
Wisconsin,Waterford Town,6526,14,7,7
Wisconsin,Waterloo,3332,7,6,1
Wisconsin,Watertown,23437,54,40,14
Wisconsin,Waukesha,72421,154,122,32
Wisconsin,Waunakee,14280,23,21,2
Wisconsin,Waupaca,5953,26,25,1
Wisconsin,Waupun,11184,18,16,2
Wisconsin,Wausau,38492,86,77,9
Wisconsin,Wautoma,2135,10,5,5
Wisconsin,Wauwatosa,48265,118,94,24
Wisconsin,Webster,616,15,15,0
Wisconsin,West Allis,59778,153,121,32
Wisconsin,West Bend,31603,67,50,17
Wisconsin,Westby,2259,4,4,0
Wisconsin,Westfield,1268,2,2,0
Wisconsin,West Milwaukee,4081,25,20,5
Wisconsin,West Salem,5037,10,9,1
Wisconsin,Whitefish Bay,13734,23,22,1
Wisconsin,Whitehall,1570,4,4,0
Wisconsin,Whitewater,14952,34,24,10
Wisconsin,Wild Rose,680,4,2,2
Wisconsin,Williams Bay,2646,8,7,1
Wisconsin,Wind Point,1692,1,1,0
Wisconsin,Winneconne,2497,6,5,1
Wisconsin,Wisconsin Dells,3025,20,15,5
Wisconsin,Wisconsin Rapids,17524,41,37,4
Wisconsin,Woodruff,1975,6,5,1
Wyoming,Afton,2055,4,4,0
Wyoming,Buffalo,4573,19,10,9
Wyoming,Casper,58244,154,99,55
Wyoming,Cheyenne,64751,122,103,19
Wyoming,Cody,9816,25,22,3
Wyoming,Diamondville,759,2,2,0
Wyoming,Douglas,6394,17,14,3
Wyoming,Evanston,11563,32,27,5
Wyoming,Evansville,3005,11,9,2
Wyoming,Gillette,32093,81,53,28
Wyoming,Glenrock,2568,13,7,6
Wyoming,Green River,11691,30,25,5
Wyoming,Greybull,1837,6,5,1
Wyoming,Hanna,762,2,2,0
Wyoming,Jackson,10668,32,26,6
Wyoming,Kemmerer,2760,6,6,0
Wyoming,Lander,7441,19,17,2
Wyoming,Laramie,32913,69,44,25
Wyoming,Lusk,1521,6,6,0
Wyoming,Mills,4040,20,15,5
Wyoming,Moorcroft,1092,4,3,1
Wyoming,Newcastle,3383,17,8,9
Wyoming,Pine Bluffs,1158,2,2,0
Wyoming,Powell,6165,22,16,6
Wyoming,Rawlins,8434,25,14,11
Wyoming,Riverton,10772,42,30,12
Wyoming,Rock Springs,22615,44,36,8
Wyoming,Saratoga,1607,7,4,3
Wyoming,Sheridan,17991,43,26,17
Wyoming,Thermopolis,2738,12,7,5
Wyoming,Torrington,6623,24,17,7
Wyoming,Wheatland,3445,10,9,1
Wyoming,Worland,4975,12,12,0
